可可西里 谁 导演 的	nz r v u	导演 查询	n v
电影 侏罗纪公园 的 导演 是 谁	n nz u n v r	导演 查询	n v
电影 茶花女 的 导演 是 谁	n nz u n v r	导演 查询	n v
蜗居 的 导演 是 谁 了	nz u n v r y	导演 查询	n v
赤壁 的 导演 是 哪个 呢	nz u n v r y	导演 查询	n v
电影 赤壁 的 导演 是 谁	n nz u n v r	导演 查询	n v
七龙珠 的 导演 是 谁	n u n v r	导演 查询	n v
电影 神话 的 导演	n nz u n	导演 查询	n v
谁 拍 的 神话	r v u nz	导演 查询	n v
电视剧 神话 的 导演 是 谁	n nz u n v r	导演 查询	n v
韩剧 皇太子的初恋 导演 是 谁	n nz n v r	导演 查询	n v
神话 是 哪个 作品 嘛	nz v r n y	导演 查询	n v
生死迷局 导演 是 谁	nz n v r	导演 查询	n v
新 拍 的 电视剧 神话 导演 是 谁 啊	a ng u n nz n v r y	导演 查询	n v
机器侠 导演 是 谁	nz n v r	导演 查询	n v
特殊使命 的 导演	nz u n	导演 查询	n v
月满轩尼诗 的 导演	nz u n	导演 查询	n v
龙门飞甲 电影 的 导演 是 谁	nz n u n v r	导演 查询	n v
越光宝盒 是 哪个 导演 拍 的	nz v r n v u	导演 查询	n v
还珠格格 的 导演 是 谁 啊	nz u n v r y	导演 查询	n v
猫的报恩 导演 是 谁	nz n v r	导演 查询	n v
快乐星球 导演 是 谁	nz n v r	导演 查询	n v
少林寺 导演 是 谁	nz n v r	导演 查询	n v
大清后宫之还君明珠 的 导演 是 谁	nz u n v r	导演 查询	n v
线人 是 谁 导演 的	nz v r n u	导演 查询	n v
康熙微服私访记 的 导演 是 谁	nz u n v r	导演 查询	n v
敢死队 谁 导 的	nz r vg u	导演 查询	n v
弹道 是 由 谁 导 的	n v p r vg u	导演 查询	n v
人在囧途 导演 是 谁	nz n v r	导演 查询	n v
铁梨花 导演 叫 什么 啊	nz n v r y	导演 查询	n v
无味神探 是 谁 导 的	nz v r vg u	导演 查询	n v
杨贵妃秘史 导演 是 谁 啊	nz n v r y	导演 查询	n v
谁 导 的 无极	r vg u nr	导演 查询	n v
电影 低俗小说 的 导演 是 谁	n nz u n v r	导演 查询	n v
暮光之城 导演	nz n	导演 查询	n v
武林外传 的 导演	nz u n	导演 查询	n v
电影 复仇者联盟 的 导演 是	n nz u n v	导演 查询	n v
红楼梦87版 电视剧 导演 是 谁	nz n n v r	导演 查询	n v
87 版 红楼梦 的 导演 是 谁	m n nz u n v r	导演 查询	n v
我 想 知道 蜗居 的 导演 是 谁	r v v nz u n v r	导演 查询	n v
奶娘 的 导演 是 谁 啊	nz u n v r y	导演 查询	n v
侏罗纪 电影 的 导演 叫 什么 名字	t n u n v r n	导演 查询	n v
娘道 导演 是 谁 呢	nz n v r y	导演 查询	n v
中国新说唱 的 导演	nz u n	导演 查询	n v
中国新说唱 导演 叫 什么	nz n v r	导演 查询	n v
一出好戏 导演 是 谁	nz n v r	导演 查询	n v
一出好戏 的 导演 的 名字 叫	nz u n u n v	导演 查询	n v
狄仁杰 导演	nz n	导演 查询	n v
李茶的姑妈 的 导演 是 谁	nz u n v r	导演 查询	n v
捉妖记 导演 是 谁	nz n v r	导演 查询	n v
橙红年代 的 导演 叫 什么	nz u n v r	导演 查询	n v
武林外传 是 谁 导演 的 呢	nz v r v u y	导演 查询	n v
战地枪王 的 导演 是 谁	nz u n v r	导演 查询	n v
这 部 片 是 谁 导演 的	r q ng v r n u	导演 查询	n v
这个 电视剧 的 导演 是 谁	r n u n v r	导演 查询	n v
谁 是 这 部 电视剧 的 导演	r v r q n u n	导演 查询	n v
这部 片子 导演 是 谁 啊	r n n v r y	导演 查询	n v
神探狄仁杰 的 导演	nz u n	导演 查询	n v
家庭秘密 的 导演 叫 什么	nz u n v r	导演 查询	n v
是 谁 导 的 辛德勒 名单	v r vg u nr n	导演 查询	n v
谁 是 这 片 的 导演	r v r q u n	导演 查询	n v
我 想 知道 导演 是 谁	r v v n v r	导演 查询	n v
美人鱼 导演 是 谁 呢	nz n v r y	导演 查询	n v
我的邻居是美女 的 导演 是 哪个	nz u n v r	导演 查询	n v
战狼 的 导演	nz u n	导演 查询	n v
战狼2 导演	nz n	导演 查询	n v
无间道 是 谁 拍 的	nz v r v u	导演 查询	n v
西游记女儿国 导演 是 谁	nz n v r	导演 查询	n v
捉妖记2 导演	nz n	导演 查询	n v
红海行动 的 导演	nz u n	导演 查询	n v
唐人街探案2 导演 是	nz n v	导演 查询	n v
宇宙有爱浪漫同游 的 导演	nz u n	导演 查询	n v
奇门遁甲 的 导演	nz u n	导演 查询	n v
心理罪之城市之光 的 导演	nz u n	导演 查询	n v
妖猫传 的 导演	nz u n	导演 查询	n v
解忧杂货店 的 导演	nz u n	导演 查询	n v
电影 芳华 的 导演	n nz u n	导演 查询	n v
栋笃特工 电影 的 导演	nz n u n	导演 查询	n v
快乐大本营 的 主持人 和 导演	nz u n c n	导演 查询	n v
黄金瞳 的 导演	nr u n	导演 查询	n v
a计划 的 主演 是 谁	nz u n v r	演员 查询	n v
冒险片 a计划 谁 主演	n nz r v	演员 查询	n v
你是我的命运 金 泰丰 的 扮演者	nz ng ns u n	演员 查询	n v
侠客行 谁 主演 啊 大陆 版 的	nz r v y n n u	演员 查询	n v
侠客 行里 叮当 是 谁 扮演 的	n n n v r v u	演员 查询	n v
假装情侣 谁 主演 的	nz r v u	演员 查询	n v
电影 假装情侣 里面 的 沈露 谁 演 的	n nz f u nr r v u	演员 查询	n v
演 假装情侣 男声 是 谁	v nz n v r	演员 查询	n v
僵尸先生 是 谁 主演	nz v r v	演员 查询	n v
八星抱喜 的 男女 主角	nz u n n	演员 查询	n v
天下无双 的 主演 是 谁	nz u n v r	演员 查询	n v
天国的阶梯 男主角 是 谁	nz n v r	演员 查询	n v
天国的阶梯 的 男主角 是 谁 扮演 的	nz u n v r v u	演员 查询	n v
天国的阶梯 韩 有 莉 小 演员 的 扮演者	nz nr v ng a n u n	演员 查询	n v
天国的阶梯 扮演 莉莉 的 演员	nz v nr u n	演员 查询	n v
寻找成龙 的 主演 是 谁	nz u n v r	演员 查询	n v
开心鬼撞鬼 女主角 叫 什么	nz n v r	演员 查询	n v
拍 开心鬼撞鬼 的 女 主叫 什么	v nz u b v r	演员 查询	n v
我是谁 是 谁 主演	nz v r v	演员 查询	n v
电影 我是谁 是 谁 主演	n nz v r v	演员 查询	n v
我是谁 是 谁 演 的	nz v r v u	演员 查询	n v
我是谁 的 主演 是 谁	nz u n v r	演员 查询	n v
我是谁 是 谁 主演	nz v r v	演员 查询	n v
我是谁 电影 谁 主演 的	nz n r v u	演员 查询	n v
我是谁 这 部 电影 是 谁 主演 的	nz r q n v r v u	演员 查询	n v
电影 我是谁 的 主演 是 哪个	n nz u n v r	演员 查询	n v
我是谁 的 主演 是 谁	nz u n v r	演员 查询	n v
电视剧 李卫当官 谁 主演	n nz r v	演员 查询	n v
无懈可击之美女如云 男主角	nz n	演员 查询	n v
李卫当官 中 的 李卫 是 谁 演 的	nz f u nr v r v u	演员 查询	n v
真爱之吻 的 女主角 叫 什么	nz u n v r	演员 查询	n v
王者之剑 里 的 男主角 叫 什么	nz f u n v r	演员 查询	n v
游侠 电影 女主角 叫 什么	n n n v r	演员 查询	n v
离婚前规则 谁 演 李小凡	nz r v nr	演员 查询	n v
离婚前规则 张小凡 扮演者 是 谁	nz nr n v r	演员 查询	n v
离婚前规则 中 小凡 的 扮演者 是	nz f nr u n v	演员 查询	n v
电影 致命性 圈 演员 名字	n n n n n	演员 查询	n v
长江7号 谁 主演	nz r v	演员 查询	n v
阿容 的 主演 是 谁	nr u n v r	演员 查询	n v
魔戒 中 的 精灵王 是 谁 演 的	nz f u n v r v u	演员 查询	n v
乌龙闯情关 中 的 女主角 是 谁	nz f u n v r	演员 查询	n v
加勒比海盗4 的 演员 是 谁	nz u n v r	演员 查询	n v
后宫 是 谁 主演 的	n v r v u	演员 查询	n v
唐山大地震 中 丫丫 是 谁 演 的	nz f nr v r v u	演员 查询	n v
唐山大地震 主演 都 有 谁	nz n d v r	演员 查询	n v
唐山大地震 中方 登 的 扮演者	nz n v u n	演员 查询	n v
唐山大地震 的 主演 谁 啊	nz u n r y	演员 查询	n v
唐山大地震 电影 中 饰演 王登 的 是 谁 啊	nz n f v nr u v r y	演员 查询	n v
唐山大地震 的 演员	nz u n	演员 查询	n v
唐山大地震 主演 都 是 谁	nz n d v r	演员 查询	n v
唐山大地震 中方 达 的 扮演者	nz n v u n	演员 查询	n v
我愿意 谁 是 主演	nz r v n	演员 查询	n v
我愿意 是 谁 主演 的 啊	nz v r v u y	演员 查询	n v
新京城四少 里 叶 姑娘 是 谁 演 的	nz f ng n v r v u	演员 查询	n v
昭君出塞 大汉 王后 是 谁 主演	nz n n v r v	演员 查询	n v
犀利人妻 的 女主角 叫 什么 名字	nz u n v r n	演员 查询	n v
穿越时空的爱恋 的 主演 是 谁	nz u n v r	演员 查询	n v
寻龙诀 的 是 谁 主演 的	nz u v r v u	演员 查询	n v
闪光少女 的 主演 有 哪些 人	nz u n v r n	演员 查询	n v
逃学威龙 的 男主角 是 谁 啊	nz u n v r y	演员 查询	n v
谁 是 寻龙诀 的 女主角	r v nz u n	演员 查询	n v
羞羞的铁拳 的 主演 有 哪些 啊	nz u n v r y	演员 查询	n v
能 告诉 我 西游记女儿国 的 主要 演员 么	v v r nz u b n y	演员 查询	n v
最 新 狄仁杰 的 主演 有 谁 啊	d a nz u n v r y	演员 查询	n v
英伦对决 的 主演	nz u n	演员 查询	n v
这 就 是 命 的 男 主叫 什么 啊	r d v n u b v r y	演员 查询	n v
老九门 的 女 主叫 啥 呢	nz u b v r y	演员 查询	n v
伪装者 的 女 主叫 什么 名字	nz u b v r n	演员 查询	n v
小王子 男 主 是 谁	n b bg v r	演员 查询	n v
火线传奇 的 男 主叫 什么	nz u b v r	演员 查询	n v
葫芦娃 男 主 是 谁	nr b bg v r	演员 查询	n v
憨豆先生 是 谁 扮演 的	nz v r v u	演员 查询	n v
美人鱼 的 男主角 是 谁	nz u n v r	演员 查询	n v
谁 是 美人鱼 的 女 主	r v nz u b n	演员 查询	n v
美人鱼 的 女 主 是 谁	nz u b n v r	演员 查询	n v
泄密者 女 猪脚 有 哪些	n b n v r	演员 查询	n v
兄弟班 的 主演 都 有 谁	nz u n d v r	演员 查询	n v
欧洲攻略 的 主演	nz u n	演员 查询	n v
无问 东西 主角	nz n n	演员 查询	n v
非同凡响 的 主演	nz u n	演员 查询	n v
黄金花 的 男女 主角	nr u n n	演员 查询	n v
幸福路 上 的 女 主 是 谁	ns f u b n v r	演员 查询	n v
前任3 的 男 主 有 哪些	nz u b bg v r	演员 查询	n v
中 英路 1 号 的 主演	j nr m q u n	演员 查询	n v
大师兄 的 主演 是 谁	n u n v r	演员 查询	n v
霸王别姬 的 虞姬 是 谁 演 的	nz u nr v r v u	演员 查询	n v
谁 是 朱茵 的 老公	r v nr u n	明星 关系 查询	n n v
朱茵 的 好友 有 哪些	nr u n v r	明星 关系 查询	n n v
朱茵 的 同学 有 哪些	nr u n v r	明星 关系 查询	n n v
谁 是 朱茵 的 同学	r v nr u n	明星 关系 查询	n n v
哪些 人 是 朱茵 的 好 朋友	r n v nr u a n	明星 关系 查询	n n v
周星驰 的 好友 有 哪些 人	nr u n v r n	明星 关系 查询	n n v
周星驰 的 好友	nr u n	明星 关系 查询	n n v
袁姗姗 的 前男友 是 哪个	nr u n v r	明星 关系 查询	n n v
袁姗姗 的 圈 内 朋友 有 哪些	nr u n f n v r	明星 关系 查询	n n v
袁姗姗 的 圈 内 好友	nr u n f n	明星 关系 查询	n n v
周杰伦 的 老婆 是 谁	nr u n v r	明星 关系 查询	n n v
周杰伦 老婆	nr n	明星 关系 查询	n n v
周杰伦 的 老婆 叫 什么	nr u n v r	明星 关系 查询	n n v
周杰伦 老婆 的 名字	nr n u n	明星 关系 查询	n n v
周杰伦 同学 的 名字	nr n u n	明星 关系 查询	n n v
周杰伦 前 女友 是 谁 啊	nr f n v r y	明星 关系 查询	n n v
刘涛 的 老公 是 谁	nr u n v r	明星 关系 查询	n n v
刘涛 丈夫 是 哪个	nr n v r	明星 关系 查询	n n v
刘涛 的 女儿 叫 什么 呢	nr u n v r y	明星 关系 查询	n n v
范冰冰 的 男朋友 是 谁	nr u n v r	明星 关系 查询	n n v
范冰冰 的 绯闻男友 有 哪些	nr u n v r	明星 关系 查询	n n v
谁 和 范冰冰 合作 过	r c nr v u	明星 关系 查询	n n v
谁 和 杨幂 合作 过	r c nr v u	明星 关系 查询	n n v
谁 和 成龙 合作 过	r c nr v u	明星 关系 查询	n n v
谁 是 周迅 的 老搭档	r v nr u n	明星 关系 查询	n n v
周迅 和 哪些 人 合作 过	nr c r n v u	明星 关系 查询	n n v
朱迅 和 谁 是 搭档	nr c r v n	明星 关系 查询	n n v
钱枫 现在 的 搭档 是 谁	nr t u n v r	明星 关系 查询	n n v
周杰伦 和 谁 合作 最 多	nr c r v d a	明星 关系 查询	n n v
周杰伦 和 谁 合作 过	nr c r v u	明星 关系 查询	n n v
郑爽 现在 男友 是 谁	nr t n v r	明星 关系 查询	n n v
张翰 的 女朋友 是 那个	nr u n v r	明星 关系 查询	n n v
张翰 的 女友 是 谁 啊	nr u n v r y	明星 关系 查询	n n v
谁 是 罗志祥 的 绯闻 女友	r v nr u n n	明星 关系 查询	n n v
谁 是 罗志祥 的 好 朋友	r v nr u a n	明星 关系 查询	n n v
陈赫 的 朋友 有 哪些	nr u n v r	明星 关系 查询	n n v
欧弟 的 好友	nr u n	明星 关系 查询	n n v
欧弟 的 老师	nr u n	明星 关系 查询	n n v
欧弟 的 同学	nr u n	明星 关系 查询	n n v
欧弟 的 老婆	nr u n	明星 关系 查询	n n v
欧弟 的 妻子 是 谁	nr u n v r	明星 关系 查询	n n v
欧弟 女儿 叫 什么	nr n v r	明星 关系 查询	n n v
孙俪 的 老公 是 谁 呢	nr u n v r y	明星 关系 查询	n n v
孙俪 的 老公 是 哪个 啊	nr u n v r y	明星 关系 查询	n n v
孙俪 的 老公 的 名字 是	nr u n u n v	明星 关系 查询	n n v
孙俪 和 儿子 叫 什么	nr c n v r	明星 关系 查询	n n v
我 想 知道 周迅 的 老公 叫 啥	r v v nr u n v r	明星 关系 查询	n n v
刘德华 的 妻子 叫 啥 呢	nr u n v r y	明星 关系 查询	n n v
你 知道 任达华 的 老婆 叫 什么 吗	r v nr u n v r y	明星 关系 查询	n n v
古天乐 的 老婆 是 谁	nr u n v r	明星 关系 查询	n n v
谁 是 古天乐 的 前 女友	r v nr u f n	明星 关系 查询	n n v
陈小春 老婆 叫 什么 名字 啊	nr n v r n y	明星 关系 查询	n n v
李呈媛 的 男友 是 谁 啊	nr u n v r y	明星 关系 查询	n n v
宋小宝 老婆 叫 什么 啊	nr n v r y	明星 关系 查询	n n v
宋小宝 的 老婆 叫 什么 啊	nr u n v r y	明星 关系 查询	n n v
宋小宝 的 老婆 叫 什么 呢	nr u n v r y	明星 关系 查询	n n v
百克力 的 女友 是 谁 啊	nr u n v r y	明星 关系 查询	n n v
百克力 女友 是 谁 呢	nr n v r y	明星 关系 查询	n n v
谁 是 石安妮 男友 呢	r v nr n y	明星 关系 查询	n n v
谁 是 石安妮 同学 呢	r v nr n y	明星 关系 查询	n n v
谁 是 柴浩伟 的 老师 啊	r v nr u n y	明星 关系 查询	n n v
告诉 我 何欢 的 前男友 是 谁 吧	v r nr u n v r y	明星 关系 查询	n n v
李易峰 女朋友 是 谁	nr n v r	明星 关系 查询	n n v
陈伟霆 老婆 是 谁	nr n v r	明星 关系 查询	n n v
谁 是 朱一龙 女朋友	r v nr n	明星 关系 查询	n n v
谁 是 吴亦凡 前 女友	r v nr f n	明星 关系 查询	n n v
谁 是 郑爽 男朋友	r v nr n	明星 关系 查询	n n v
郑爽 男友 是 谁	nr n v r	明星 关系 查询	n n v
范丞丞 女友 是 谁 啊	nr n v r y	明星 关系 查询	n n v
谁 是 任贤齐 的 老婆	r v nr u n	明星 关系 查询	n n v
哪些 人 是 任贤齐 的 圈 内 好友	r n v nr u n f n	明星 关系 查询	n n v
谁 是 黄珊珊 的 前 女友	r v nr u f n	明星 关系 查询	n n v
何洁 老公 是 谁	nr n v r	明星 关系 查询	n n v
谁 是 何洁 老公 啊	r v nr n y	明星 关系 查询	n n v
胡可 的 老公 叫 什么	nr u n v r	明星 关系 查询	n n v
刘涛 的 老公 叫 啥	nr u n v r	明星 关系 查询	n n v
董洁 的 老公 叫 什么 呢	nr u n v r y	明星 关系 查询	n n v
谁 是 董洁 老公 啊	r v nr n y	明星 关系 查询	n n v
天气 怎么样	n r	天气 查询	n v
上海 一直 下雨	ns d v	天气 查询	n v
宝山 有 冰雹 天气	ns v n n	天气 查询	n v
江苏 又 大暴雨	ns d n	天气 查询	n v
上海 今天 天气 怎样	ns t n r	天气 查询	n v
北京 未来 一 周 都 有 雨 吗	ns t m q d v n y	天气 查询	n v
上海 明天 高温	ns t n	天气 查询	n v
重庆 明天 阴天 么	ns t n y	天气 查询	n v
武汉 明天 有 雨 么	ns t v n y	天气 查询	n v
明天 是 晴天 嘛	t v n y	天气 查询	n v
上海 今日 有 大风 嘛	ns t v n y	天气 查询	n v
浙江 明天 会 有 大雾 吗	ns t v v n y	天气 查询	n v
沈阳 最近 有 雨夹雪 吗	ns t v l y	天气 查询	n v
今天 空气 适合 跑步 吗	t n v v y	天气 查询	n v
适合 穿 短裤 吗	v v n y	天气 查询	n v
今天 适合 穿 什么	t v v r	天气 查询	n v
今天 能 洗 车 吗	t v v n y	天气 查询	n v
明天 天气 适合 外出 打球	t n v v v	天气 查询	n v
明天 天气 可以 去 故宫 旅游 吗	t n v v ns vn y	天气 查询	n v
最近 天气 容易 导致 感冒 吗	t n a v v y	天气 查询	n v
天气 好 吗	n a y	天气 查询	n v
成都 下雨 么	ns v y	天气 查询	n v
深圳 晴天	ns n	天气 查询	n v
静安区 高温	ns n	天气 查询	n v
河南 阴天	ns n	天气 查询	n v
福建 昨天 下 了 一 天雨	ns t v u m nr	天气 查询	n v
广州 这个 月 很 热	ns r n d k	天气 查询	n v
天津 这 一 周 高温 吗	ns r m q n y	天气 查询	n v
香港 今天 阴天 吗	ns t n y	天气 查询	n v
武汉 今天 晴天 嘛	ns t n y	天气 查询	n v
山东 今天 有 雨 么	ns t v n y	天气 查询	n v
西安 下雪 了 吗	ns v y y	天气 查询	n v
西城区 大雨 吗	ns n y	天气 查询	n v
湖北 下雪 吗	ns n y	天气 查询	n v
辽宁 这个 礼拜 冷 吗	ns r n a y	天气 查询	n v
佛山 一整天 都 是 阴天	ns t d v n	天气 查询	n v
墨尔本 今天 晴天 吗	nz t n y	天气 查询	n v
河北 最近 有点 冷	ns t d a	天气 查询	n v
珠海 昨天 是 阴天	ns t v n	天气 查询	n v
纽约 一直 下雨 吧	ns d v y	天气 查询	n v
伦敦 有 大雾 么	ns v n y	天气 查询	n v
后天 的 天气	n u n	天气 查询	n v
明天 天气	t n	天气 查询	n v
明天 下雨 吗	t v y	天气 查询	n v
明天 下 不 下雨 啊	t f d v y	天气 查询	n v
上海 下周 天气	ns t n	天气 查询	n v
下雨 吗 明天	v y t	天气 查询	n v
明天 天气 怎么样	t n r	天气 查询	n v
明天 天气 还 好 吧	t n d a y	天气 查询	n v
后天 天气	n n	天气 查询	n v
后天 下 不 下雨 呀	n f d v y	天气 查询	n v
今天 下午 下雨 吗	t t v y	天气 查询	n v
明天 早上 下 不 下雨 啊	t t f d v y	天气 查询	n v
上海 今天 晚上 下雨 嘛	ns t t v y	天气 查询	n v
告诉 我 北京 下周 天气	v r ns t n	天气 查询	n v
横店 明天 天气	ns t n	天气 查询	n v
北京 天气预报	ns n	天气 查询	n v
江城 下周 天气	ns t n	天气 查询	n v
济阳 五 天 天气预报	ns m q n	天气 查询	n v
泸州 未来 七 天 天气	ns t m q n	天气 查询	n v
赤水 下 个 礼拜 的 天气 情况	ns f q n u n n	天气 查询	n v
禹城 三 天 天气预报	nr m q n	天气 查询	n v
三天 天气预报	nz n	天气 查询	n v
未来 五 天 天气 情况	t m q n n	天气 查询	n v
未来 七 天 天气预报	t m q n	天气 查询	n v
下周 天气预报	t n	天气 查询	n v
下 个 礼拜 的 天气预报	f q n u n	天气 查询	n v
昌邑 下周 天气	ns t n	天气 查询	n v
耿马 后面 3 天 天气	nr f m q n	天气 查询	n v
三亚 接 下来 几 天 天气预报	ns v v m q n	天气 查询	n v
下周 珠海 天气	t ns n	天气 查询	n v
湛江 明天 天气 怎么样	ns t n r	天气 查询	n v
吴川 未来 几 天 天气 情况	nr t m q n n	天气 查询	n v
龙海 天气预报	nr n	天气 查询	n v
周二 天气 怎么样	nr n r	天气 查询	n v
周末 三亚 天气 怎样	t ns n r	天气 查询	n v
下周三 厦门 天气 好 不 好	t ns n a d a	天气 查询	n v
周五 长沙 天气 情况	t ns n n	天气 查询	n v
告诉 我 北京 下周一 天气 情况	v r ns t n n	天气 查询	n v
下周 天气 咋样	t n r	天气 查询	n v
周五 天气 好 吗	t n a y	天气 查询	n v
上海 周日 的 天气	ns t u n	天气 查询	n v
无锡 周五 天气 情况	ns t n n	天气 查询	n v
重庆 下周 二 的 天气	ns t m u n	天气 查询	n v
9月10 号 天气预报	m q n	天气 查询	n v
2月08 号 天气预报	m q n	天气 查询	n v
3月25 号 天气预报	m q n	天气 查询	n v
四月 一 号 天气预报	t m q n	天气 查询	n v
11 号 的 天气 情况	m q u n n	天气 查询	n v
10月24日 上海 天气	t ns n	天气 查询	n v
11月20 号 北京 天气	m q ns n	天气 查询	n v
告诉 我 1月2 号 无锡 的 天气	v r m q ns u n	天气 查询	n v
请问 2月10 号 左右 宁波 的 天气 情况	v m q m ns u n n	天气 查询	n v
请问 十一 期间 大连 天气	v m f ns n	天气 查询	n v
五一 青岛 天气	m ns n	天气 查询	n v
清明 杭州 天气预报	t ns n	天气 查询	n v
4月10 号 附近 衡阳 的 天气	m q f ns u n	天气 查询	n v
6月1日 重庆 天气	t ns n	天气 查询	n v
五一 重庆 天气	m ns n	天气 查询	n v
十一 期间 成都 天气	m f ns n	天气 查询	n v
国庆 期间 杭州 天气	t f ns n	天气 查询	n v
六月 二十 号 天气 情况	n m q n n	天气 查询	n v
四月 一 号 宁波 天气	t m q ns n	天气 查询	n v
十二月 三十 福州 天气 好 吗	t m ns n a y	天气 查询	n v
八月 八号 那天 济南 天气 好 么	t nz r ns n a y	天气 查询	n v
七月 十二大阪 天气	t i n	天气 查询	n v
下周 二 上海 天气 好 么	t m ns n a y	天气 查询	n v
下周一 上海 天气	n ns n	天气 查询	n v
下周 二 天气	t m n	天气 查询	n v
下周 五 厦门 天气 好 么	t m ns n a y	天气 查询	n v
下周 末 的 天气 情况	t f u n n	天气 查询	n v
下周 六 成都 天气	t m ns n	天气 查询	n v
杭州 周末 天气	ns t n	天气 查询	n v
济南 这 周末 天气预报	ns r t n	天气 查询	n v
成都 这 周五 天气 情况	ns r t n n	天气 查询	n v
合肥 周天 天气	ns nr n	天气 查询	n v
济阳 下周 四 天气	ns t m n	天气 查询	n v
芜湖 下周 天气预报	ns t n	天气 查询	n v
星期一 天气 怎么样	t n r	天气 查询	n v
武汉 星期二 天气 如何	ns t n r	天气 查询	n v
天津 星期三 的 天气 好 么	ns t u n a y	天气 查询	n v
贵阳 星期日 天气预报	ns t n	天气 查询	n v
上海 星期天 天气 咋样	ns t n r	天气 查询	n v
星期五 重庆 的 天气 情况	t ns u n n	天气 查询	n v
星期六 北京 天气	t ns n	天气 查询	n v
星期四 杭州 天气	t ns n	天气 查询	n v
百度 的 股票	nz u n	股票 查询	n v
腾讯 的 股票	nz u n	股票 查询	n v
阿里巴巴 的 股票	nr u n	股票 查询	n v
给 我 看 爱奇艺 的 股票	p r v nz u n	股票 查询	n v
给 我 看 网易 的 股票	p r v nz u n	股票 查询	n v
给 我 看 百度 的 股票	p r v nz u n	股票 查询	n v
大盘 指数	n n	股票 查询	n v
百度 股价	nz n	股票 查询	n v
中石油 当前 成交量	n t n	股票 查询	n v
中石油 今天 股票 行情	n t n n	股票 查询	n v
中石化 股票 行情	j n n	股票 查询	n v
中石油 今天 行情	n t n	股票 查询	n v
中石油 今天 走势	n t n	股票 查询	n v
600028 股价	m n	股票 查询	n v
600028 当前 股价	m t n	股票 查询	n v
600028 当前 成交量	m t n	股票 查询	n v
600028 今天 股票 行情	m t n n	股票 查询	n v
600028 今天 行情	m t n	股票 查询	n v
600028 走势	m n	股票 查询	n v
爱奇艺 股价	nz n	股票 查询	n v
爱奇艺 当前 股价	nz t n	股票 查询	n v
爱奇艺 当前 成交量	nz t n	股票 查询	n v
爱奇艺 今天 股票 行情	nz t n n	股票 查询	n v
爱奇艺 行情	nz n	股票 查询	n v
爱奇艺 走势	nz n	股票 查询	n v
中石油 股价	n n	股票 查询	n v
中石油 当前 股价	n t n	股票 查询	n v
中石油 当前 成交量	n t n	股票 查询	n v
中石油 今天 股票 行情	n t n n	股票 查询	n v
今天 乐视网 股价	t nz n	股票 查询	n v
今天 乐视网 成交量	t nz n	股票 查询	n v
今天 乐视网 行情	t nz n	股票 查询	n v
今天 乐视网 股票 走势	t nz n n	股票 查询	n v
601857 股价	m n	股票 查询	n v
601857 当前 股价	m t n	股票 查询	n v
601857 当前 成交量	m t n	股票 查询	n v
601857 今天 股票 行情	m t n n	股票 查询	n v
601857 行情	m n	股票 查询	n v
601857 今天 走势	m t n	股票 查询	n v
桂林 旅游 股价	ns vn n	股票 查询	n v
桂林 旅游 当前 股价	ns vn t n	股票 查询	n v
桂林 旅游 当前 成交量	ns vn t n	股票 查询	n v
桂林 旅游 今天 股票 行情	ns vn t n n	股票 查询	n v
桂林 旅游 市值	ns vn n	股票 查询	n v
桂林 旅游 股票 走势	ns vn n n	股票 查询	n v
顺 网 科技 股价	p n n n	股票 查询	n v
顺 网 科技 当前 股价	p n n t n	股票 查询	n v
顺 网 科技 当前 成交量	p n n t n	股票 查询	n v
顺 网 科技 今天 股票 行情	p n n t n n	股票 查询	n v
顺 网 科技 市值	p n n n	股票 查询	n v
顺 网 科技 股票 行情	p n n n n	股票 查询	n v
300113 股价	m n	股票 查询	n v
300113 当前 股价	m t n	股票 查询	n v
300113 当前 成交量	m t n	股票 查询	n v
300113 今天 股票 行情	m t n n	股票 查询	n v
300113 市值	m n	股票 查询	n v
300114 股价	m n	股票 查询	n v
300114 当前 股价	m t n	股票 查询	n v
300114 当前 成交量	m t n	股票 查询	n v
300114 今天 股票 行情	m t n n	股票 查询	n v
300114 市值	m n	股票 查询	n v
300123 股价	m n	股票 查询	n v
300123 当前 走势	m t n	股票 查询	n v
300123 当前 行情	m t n	股票 查询	n v
300123 今天 成交量	m t n	股票 查询	n v
300123 市值	m n	股票 查询	n v
中石化 股票 行情	j n n	股票 查询	n v
中石油 股票 走势	n n n	股票 查询	n v
上证 指数	j n	股票 查询	n v
深证 成指 指数	j j n	股票 查询	n v
港股 指数	n n	股票 查询	n v
美股 指数	n n	股票 查询	n v
创业板 指数	n n	股票 查询	n v
新三板 指数	n n	股票 查询	n v
中国 石化 股价	ns j n	股票 查询	n v
中国 联合 通信 股份 有限公司 股价	ns v vn n n n	股票 查询	n v
宝山 钢铁 股份 有限公司 股价	ns n n n n	股票 查询	n v
重庆 长安 汽车 股份 有限公司 股价	ns nz n n n n	股票 查询	n v
华能 国际 电力 股份 有限公司 股价	nz n n n n n	股票 查询	n v
上海 汽车 股份 有限公司 股价	ns n n n n	股票 查询	n v
中国 国际 海运 集装箱 集团 股份 有限公司 股价	ns n vn n n n n n	股票 查询	n v
五矿 龙腾 科技 股份 有限公司 股价	j nz n n n n	股票 查询	n v
哈药 集团 股份 股价	nz n n n	股票 查询	n v
青岛 海尔 股份 股价	ns nz n n	股票 查询	n v
宜宾 五粮液 股份 有限公司 股价	ns n n n n	股票 查询	n v
四川 长虹 电器 股份 有限公司 股价	ns nz n n n n	股票 查询	n v
贵州 茅台酒 股份 有限公司 股价	ns n n n n	股票 查询	n v
安徽 海螺 水泥 股份 有限公司 股价	ns n n n n n	股票 查询	n v
一汽 轿车 股份 有限公司 股价	j n n n n	股票 查询	n v
中国 石化 仪征化纤 股份 有限公司 股价	ns j i n n n	股票 查询	n v
万科 企业 股份 股价	nz n n n	股票 查询	n v
青岛 啤酒 股份 有限公司 股价	ns n n n n	股票 查询	n v
招商银行 股份 股价	nz n n	股票 查询	n v
内蒙古 伊利 实业 集团 股份 有限公司 股价	ns nz n n n n n	股票 查询	n v
北京 同仁堂 股份 有限公司 股价	ns nz n n n	股票 查询	n v
上海 光明 乳业 股价	ns n n n	股票 查询	n v
中国 南方 航空 股份 有限公司 股价	ns f n n n n	股票 查询	n v
江西 赣南 果业 股份 有限公司 股价	ns ns n n n n	股票 查询	n v
广东 美的集团 股份 有限公司 股价	ns n n n n	股票 查询	n v
爱奇艺 股票 怎么样	nz n r	股票 查询	n v
限行	v	限行 查询	v v
限行 情况	v n	限行 查询	v v
限行 信息	v n	限行 查询	v v
限行 政策	v n	限行 查询	v v
告诉 我 限行 的 情况	v r v u n	限行 查询	v v
上海 今天 限行	ns t v	限行 查询	v v
北京 明天 限行	ns t v	限行 查询	v v
重庆 昨天 限行	ns t v	限行 查询	v v
上海 今天 下午 限行	ns t t v	限行 查询	v v
武汉 明天 也 限行	ns t d v	限行 查询	v v
今天 限 号 是 尾 号 为 2	t v n v ng n v m	限行 查询	v v
今天 限 号 尾 号	t v q ng q	限行 查询	v v
今天 限 号 尾 号	t v q ng q	限行 查询	v v
今天 限行 吗	t v y	限行 查询	v v
明天 限行 的 情况	t v u n	限行 查询	v v
上海 明天 限行	ns t v	限行 查询	v v
北京 限行 信息	ns v n	限行 查询	v v
北京 限行 信息	ns v n	限行 查询	v v
上海 今天 限行 吗	ns t v y	限行 查询	v v
今天 上海 限行 吗	t ns v y	限行 查询	v v
今天 上海 限行 么	t ns v y	限行 查询	v v
明天 北京 限行 吗	t ns v y	限行 查询	v v
北京 明天 限行 么	ns t v y	限行 查询	v v
后天 北京 限行 嘛	t ns v y	限行 查询	v v
北京 后天 限行 吗	ns n v y	限行 查询	v v
今天 限行 吗	t v y	限行 查询	v v
明天 限行 么	t v y	限行 查询	v v
后天 限行 嘛	ns v y	限行 查询	v v
北京 限行 吗	ns v y	限行 查询	v v
明天 北京 限行 的 尾 号 是 1 吗	t ns v u ng n v m y	限行 查询	v v
今天 北京 限 不 限行	t ns ng d v	限行 查询	v v
明天 北京 限 不 限行	t ns ng d v	限行 查询	v v
今天 上海 限 不 限行	t ns ng d v	限行 查询	v v
明天 上海 限 不 限行	t ns ng d v	限行 查询	v v
上海 明天 全天 限行	ns t t v	限行 查询	v v
北京 明天 全天 限行	ns t t v	限行 查询	v v
上海 外地车 限行 吗	ns n v y	限行 查询	v v
外地车 上海 限行 嘛	n ns v y	限行 查询	v v
北京 外地车 限行 么	ns n v y	限行 查询	v v
外地车 北京 限行 吗	n ns v y	限行 查询	v v
上海 外地 车牌 限行 时间	ns s n v n	限行 查询	v v
2018 年 上海 限行 新 规定 及 限行 时间	m q ns v a n c v n	限行 查询	v v
上海 今天 不 限行 吗	ns t d v y	限行 查询	v v
北京 限行 最 新 通知	ns v d a n	限行 查询	v v
上海 限行 最 新 通知	ns v d a n	限行 查询	v v
广州 限行	ns v	限行 查询	v v
深圳 限行	ns v	限行 查询	v v
上海 外地 牌照 限行	ns s n v	限行 查询	v v
上海 沪 c 限行	ns j nx v	限行 查询	v v
上海 高架 限行	ns n v	限行 查询	v v
北京 外地 牌照 限行	ns s n v	限行 查询	v v
上海 今天 不 限行	ns t d v	限行 查询	v v
上海 限行 区域	ns v n	限行 查询	v v
北京 限行 区域	ns v n	限行 查询	v v
上海 限行 规定	ns v n	限行 查询	v v
北京 限行 规定	ns v n	限行 查询	v v
上海 限行 政策	ns v n	限行 查询	v v
北京 限行 政策	ns v n	限行 查询	v v
国庆 上海 限行 么	t ns v y	限行 查询	v v
明天 北京 单 号 限行 么	t ns m q v y	限行 查询	v v
成都 有 限行 么	ns v v y	限行 查询	v v
清明 西安 限行 吗	t ns v y	限行 查询	v v
杭州 节假日 限行 规定 是 怎样 的	ns t v v v r u	限行 查询	v v
告诉 我 明天 上海 限行 么	v r t ns v y	限行 查询	v v
清明 北京 限行 吗	t ns v y	限行 查询	v v
北京 中秋 限行 不 限行	ns t v d v	限行 查询	v v
端午节 上海 限行 不	t ns v d	限行 查询	v v
国庆节 杭州 限行 么	t ns v y	限行 查询	v v
请问 元旦 北京 限 不 限行	v t ns ng d v	限行 查询	v v
我 想 知道 劳动节 深圳 限行 情况	r v v t ns v n	限行 查询	v v
春节 的 时候 深圳 限行 吗	t u n ns v y	限行 查询	v v
周二 限行 么	nr v y	限行 查询	v v
周末 三亚 限行 吗	t ns v y	限行 查询	v v
下周 三 厦 门限 不 限行 呢	t m ng n d v y	限行 查询	v v
周五 长沙 限行 吗	t ns v y	限行 查询	v v
告诉 我 北京 下周一 限行 规定	v r ns n v n	限行 查询	v v
周五 限行 吗	t v y	限行 查询	v v
无锡 周五 限行 么	ns t v y	限行 查询	v v
重庆 下周 二 限行 吗	ns t m v y	限行 查询	v v
5 号 重庆 限行 吗	m q ns v y	限行 查询	v v
14 号 北京 限行 么	m q ns v y	限行 查询	v v
8月1 号 北京 限行 么	m q ns v y	限行 查询	v v
2月14日 杭州 限 不 限行	t ns ng d v	限行 查询	v v
十一 期间 青岛 限行 吗	m f ns v y	限行 查询	v v
五一 期间 限行 吗	m f v y	限行 查询	v v
十月 一 号 那天 上海 限行 吗	t m q r ns v y	限行 查询	v v
四月 十 号 限行 么	t m q v y	限行 查询	v v
五月 三十 那天 限行 吗	t m r v y	限行 查询	v v
九月 十一 杭州 限行 吗	t m ns v y	限行 查询	v v
十二月 二十 号 北京 限 不 限行 呢	t m q ns ng d v y	限行 查询	v v
下周 二 上海 限行 吗	t m ns v y	限行 查询	v v
北京 下周 五 限 不 限行	ns t m ng d v	限行 查询	v v
下周一 沈阳 限行 情况	n ns v n	限行 查询	v v
周天 上海 限行 吗	nr ns v y	限行 查询	v v
下周 末 北京 限行 吗	t f ns v y	限行 查询	v v
周末 天津 限行 么	t ns v y	限行 查询	v v
下周 六 贵阳 限行 吗	t m ns v y	限行 查询	v v
下周 三 限行 吗	t m v y	限行 查询	v v
长春 下周 五 限行 政策	ns t m v n	限行 查询	v v
周四 限 不 限行	t v d v	限行 查询	v v
一月 一 号 那天 芜湖 限行 吗	t m q r ns v y	限行 查询	v v
春节 期间 深圳 限行 吗	t f ns v y	限行 查询	v v
春节 上海 限行 么	t ns v y	限行 查询	v v
长春 限行 政策	ns v n	限行 查询	v v
星期一 武汉 限行 吗	t ns v y	限行 查询	v v
武汉 星期二 限行 么	ns t v y	限行 查询	v v
天津 星期三 限行 不	ns t v d	限行 查询	v v
贵阳 星期日 限行 情况	ns t v n	限行 查询	v v
上海 星期天 限行 吗	ns t v y	限行 查询	v v
星期五 重庆 限行 么	t ns v y	限行 查询	v v
星期六 北京 限行 规定	t ns v n	限行 查询	v v
星期四 杭州 限行 吗	t ns v y	限行 查询	v v
苏州 限行 吗	ns v y	限行 查询	v v
杭州 限行 嘛	ns v y	限行 查询	v v
苏州 限行 么	ns v y	限行 查询	v v
北京 今天 限行 吗	ns t v y	限行 查询	v v
今天 浦东 限行 吗	t ns v y	限行 查询	v v
帮 我 跳转 到 周星驰 出现 的 片段	v r v p nr v u n	内容 跳转	n v
我 要 看 赵丽颖 出场 的 那 段	r v v nr v u r q	内容 跳转	n v
我 要 看 赵丽颖 哭 的 那 段	r v v nr v u r q	内容 跳转	n v
我 想 看 杨幂 和 黄子韬 拥抱 的 那段	r v v nr c nr v u r	内容 跳转	n v
我 要 看 臣妾做不到啊 的 那段	r v v nz u r	内容 跳转	n v
我 要 看 真相大白 的 那段	r v v i u r	内容 跳转	n v
帮 我 跳转 到 一生所爱 响起 的 片段	v r v p nz v u n	内容 跳转	n v
我 要 看 梁朝伟 被 一 枪 打中 头部 的 那段	r v v nr p m q v n u r	内容 跳转	n v
直接 放 黄秋生 从 楼顶 被 扔 下来 那 段 眼 神戏	ad v nr p n p v v r q n n	内容 跳转	n v
直接 放 犹太人 集中营 那里	ad v n n r	内容 跳转	n v
直接 跳 到 学生 一起 站 在 桌上 那里	ad v p n d v p s r	内容 跳转	n v
跳转 到 洪金宝 被 围攻 那里	v p nr p v r	内容 跳转	n v
跳转 到 下雪 那里	v p n r	内容 跳转	n v
我 要 看 开头 那 一 段	r v v n r m q	内容 跳转	n v
直接 放 结尾 片段	ad v n n	内容 跳转	n v
给 我 放 周星驰 被 导演 耍大牌 那段	p r v nr p n n r	内容 跳转	n v
给 我 看 周星驰 心里 独白 那段	p r v nr s n r	内容 跳转	n v
我 要 看 周星驰 和 张柏芝 在 树 下 那段	r v v nr c nr p n f r	内容 跳转	n v
我 要 看 马 亨达 被 一 家 灭门 那段	r v v n nr p m q n r	内容 跳转	n v
放 程蝶衣 烧 戏 服 的 那 一 段	v n v n v u r m q	内容 跳转	n v
放 我 养 你 啊 的 那段	v r v r y u r	内容 跳转	n v
我 要 看 至尊宝 和 紫霞 在 城墙 上 的 那 段	r v v nr c n p n f u r q	内容 跳转	n v
跳转 到 孙悟空 踩 七彩 祥云 的 那段	v p nr v n nr u r	内容 跳转	n v
直接 放 段天涯 刚 出场 的 收 刀 式	ad v nr d v u v n k	内容 跳转	n v
我 想 看 王宝强 的 动作 戏	r v v nr u n n	内容 跳转	n v
我 想 看 王宝强 的 搞笑 片段	r v v nr u vn n	内容 跳转	n v
跳转 到 张雨绮 的 亲热戏	v p nr u n	内容 跳转	n v
我 要 从 情节 翻转 的 部分 开始 看	r v p n v u n v v	内容 跳转	n v
我 要 从 刘昊然 开始 推理 的 地方 开始 看	r v p nr v v u n v v	内容 跳转	n v
我 要 看 结尾 的 彩蛋	r v v n u n	内容 跳转	n v
我 想 看 结尾 的 彩蛋	r v v n u n	内容 跳转	n v
跳转 到 真相大白 的 片段	v p i u n	内容 跳转	n v
我 要 从 肖央 被 怀疑 开始 看	r v p nr p v v v	内容 跳转	n v
我 要 看 三 人 一起 走 出来 那段	r v v m n s v v r	内容 跳转	n v
直接 放 成龙 的 动作 戏	ad v nr u n n	内容 跳转	n v
从 成龙 被害 开始 放	p nr vn v v	内容 跳转	n v
放 成龙 跑酷 那段	v nr v r	内容 跳转	n v
放 张国荣 在 桥 上 抽烟 那 段	v nr p n f v r q	内容 跳转	n v
我 要 看 张国荣 骑 摩托车	r v v nr v n	内容 跳转	n v
我 要 看成 龙 一个 打 十 个 的 那 段 打戏	r v v n m v m q u r q n	内容 跳转	n v
我 要 看 穿帮 的 镜头	r v v v u n	内容 跳转	n v
直接 放 穿帮 的 那里	ad v v u r	内容 跳转	n v
从 下雪 那里 开始 放	p n r v v	内容 跳转	n v
我 想 直接 看 结尾	r v ad v n	内容 跳转	n v
跳转 到 大家 送别 燕小六 的 片段	v p r v nr u n	内容 跳转	n v
我 要 看 林更新 出场 的 那 段	r v v nr v u r q	内容 跳转	n v
我 想 看 林更新 哭 的 那 段	r v v nr v u r q	内容 跳转	n v
我 要 看 林更新 和 林允儿 拥抱 的 那段	r v v nr c nr v u r	内容 跳转	n v
跳转 到 念 诗 的 那 段	v v v n u r q	内容 跳转	n v
我 要 看 故事 的 高潮 部分	r v v n u n n	内容 跳转	n v
跳转 到 成龙 跳 车 的 片段	v p nr v n u n	内容 跳转	n v
我 要 看 梁朝伟 和 刘德华 在 楼顶 的 那段	r v v nr c nr p n u r	内容 跳转	n v
直接 放 黄渤 的 眼神 戏	ad v nr u n n	内容 跳转	n v
直接 放 徐峥 出场 那里	ad v nr v r	内容 跳转	n v
直接 跳 到 黄渤 和 徐峥 的 对手戏	ad v v nr c nr u n	内容 跳转	n v
跳转 到 李易峰 被 关 到 小黑屋 那里	v p nr p v v n r	内容 跳转	n v
跳 到 小刀会序曲 响起 的 地方	v p nz v u n	内容 跳转	n v
我 要 看 徐峥 被 戳穿 那 一 段	r v v nr p v r m q	内容 跳转	n v
直接 放 火场 救人 那段	ad v n v r	内容 跳转	n v
给 我 放 沈腾 换装 那段	p r v nr v r	内容 跳转	n v
给 我 看 李易峰 心里 独白 那段	p r v nr s n r	内容 跳转	n v
我 要 看 刘亦菲 出场 那段	r v v nr v r	内容 跳转	n v
我 想 看 少林寺 被 被 灭门 那段	r v v nz p p n r	内容 跳转	n v
放 洪金宝 和 黑帮 打 的 那 一 段	v nr c n v u r m q	内容 跳转	n v
放 吕子乔 醒悟 的 那段	v nr v u r	内容 跳转	n v
我 要 看 曾小贤 和 诺兰 在一起 的 那 段	r v v nr c nr nz u r q	内容 跳转	n v
跳转 到 求婚 的 那 段	v p v u r q	内容 跳转	n v
直接 放 到 南极 那里	ad v v ns r	内容 跳转	n v
我 想 看 李连杰 的 动作 戏	r v v nr u n n	内容 跳转	n v
我 想 看 黄渤 的 搞笑 片段	r v v nr u vn n	内容 跳转	n v
我 要 看 胡歌 的 出场 部分	r v v nr u vn n	内容 跳转	n v
我 要 从 周润发 被 枪击 开始 看	r v p nr p v v v	内容 跳转	n v
我 要 从 周迅 披 上 画皮 的 地方 开始 看	r v p nr v f nz u n v v	内容 跳转	n v
直接 放 结尾 的 彩蛋	ad v n u n	内容 跳转	n v
我 想 看 真相大白 的 部分	r v v i u n	内容 跳转	n v
跳转 到 黄渤 快 饿 死 那里	v p nr d v v r	内容 跳转	n v
我 要 从 黄渤 开始 养 牛 开始 看	r v p nr v v n v v	内容 跳转	n v
我 要 看 吕秀才 逼死 姬无命 那段	r v v nr v n r	内容 跳转	n v
直接 放 甄子丹 的 动作 戏	ad v nr u n n	内容 跳转	n v
从 黄秋生 被害 开始 放	p nr vn v v	内容 跳转	n v
放 张国荣 唱 京剧 那段	v nr v n r	内容 跳转	n v
放 吕秀才 和 郭芙蓉 互怼 的 部分	v nr c nr vn u n	内容 跳转	n v
我 要 看 白展堂 告白	r v v nr v	内容 跳转	n v
我 要 看 郭芙蓉 欺负 吕秀才 的 那 段 戏	r v v nr v nr u r q n	内容 跳转	n v
从 白展堂 和 佟湘玉 闹 分手 开始 播	p nr c nr v v v v	内容 跳转	n v
直接 放 老白 假扮 黄豆豆 的 那里	ad v nr v nr u r	内容 跳转	n v
从 柳星雨 以 死相 逼 那里 开始 放	p nr p n v r v v	内容 跳转	n v
我 想 直接 看 骗子 被 识破	r v ad v n p v	内容 跳转	n v
我 要 看 对不起我是警察 的 那段	r v v nz u r	内容 跳转	n v
我 想 看 出来混迟早是要还的 那 段	r v v nz r q	内容 跳转	n v
我 要 看 我 是 假 霸王 你 是 真 虞姬 的 片段	r v v r v a n r v a nr u n	内容 跳转	n v
我 想 看 最 好 的 威胁 是 不 采取 行动 那段	r v v d a u vn v d v vn r	内容 跳转	n v
我 要 看 我 不 想 死 我 要 活 着 的 那 段	r v v r d v v r v v u u r q	内容 跳转	n v
我 想 看 但 你 不 可以 说 我 是 臭 跑龙套 的 那段	r v v c r d v v r v a n u r	内容 跳转	n v
看 曾经 有 份 真挚 的 爱情 放 在 我 面前 那段	v d v q a u n v p r f r	内容 跳转	n v
我 要 看 我 的 意中人 是 个 盖世英雄 的 那段	r v v r u n v q i u r	内容 跳转	n v
我 要 看 那个人 好像 一 条 狗 诶 的 那 段	r v v nr d m q n e u r q	内容 跳转	n v
看 人 是 人 他 妈 生 的 那 段	v n v n r n v u r q	内容 跳转	n v
我 要 看 我 猜 到 了 开头 却 猜 不 中 结局 的 那 段	r v v r v v u n d v d f n u r q	内容 跳转	n v
我 想 看 这个 鱼塘 被 你 承包 了 的 那 段	r v v r n p r v u u r q	内容 跳转	n v
我 要 看 让 我 去 睡服 他 的 那段	r v v v r v v r u r	内容 跳转	n v
我 要 看 我 恨 你 但 我 也 只有你 的 那 段	r v v r v r c r d nz u r q	内容 跳转	n v
只 看 周星驰 的 镜头	d v nr u n	演员 限定	n v
只 看 周星驰	d v nr	演员 限定	n v
只 看 赵丽颖	d v nr	演员 限定	n v
只 看 赵丽颖 的 部分	d v nr u n	演员 限定	n v
只 看 赵丽颖 的 片段	d v nr u n	演员 限定	n v
我 只 想 看 张国荣	r d v v nr	演员 限定	n v
我 只 想 看 有 张国荣 的 地方	r d v v v nr u n	演员 限定	n v
我 只 想 看 有 周润发 的 部分	r d v v v nr u n	演员 限定	n v
我 只 想 看 张国荣 演 的 片段	r d v v nr v u n	演员 限定	n v
我 只 想 看 周润发 的 镜头	r d v v nr u n	演员 限定	n v
只 看 林青霞 出演 的 镜头	d v nr v u n	演员 限定	n v
只 看 有 林青霞 出现 的 地方	d v v nr v u n	演员 限定	n v
只 看 周杰伦 演 的 片段	d v nr v u n	演员 限定	n v
只 看 刘德华	d v nr	演员 限定	n v
只 看 刘德华 的 镜头	d v nr u n	演员 限定	n v
只 看 刘德华 的 片段	d v nr u n	演员 限定	n v
只 看 刘德华 的 部分	d v nr u n	演员 限定	n v
只 看 有 林更新 的 镜头	d v v nr u n	演员 限定	n v
只 看 有 林更新 的 片段	d v v nr u n	演员 限定	n v
只 看 有 林更新 的 部分	d v v nr u n	演员 限定	n v
只 看 有 张柏芝 的 地方	d v v nr u n	演员 限定	n v
只 看 有 张柏芝 的 片段	d v v nr u n	演员 限定	n v
只 看 有 张柏芝 的 镜头	d v v nr u n	演员 限定	n v
只 看 有 张柏芝 的 部分	d v v nr u n	演员 限定	n v
我 只 看 梁朝伟 的 戏	r d v nr u n	演员 限定	n v
我 只 看 梁朝伟 出演 的 镜头	r d v nr v u n	演员 限定	n v
我 只 看成 龙 出演 的 部分	r d v n v u n	演员 限定	n v
我 就 想 看成 龙 的 镜头	r d v v n u n	演员 限定	n v
我 就 想 看 有 成龙 的 地方	r d v v v nr u n	演员 限定	n v
我 就 想 看 梁朝伟 演 的 片段	r d v v nr v u n	演员 限定	n v
只 放 周星驰	d v nr	演员 限定	n v
只 放 有 周星驰 的 部分	d v v nr u n	演员 限定	n v
只 放 周星驰 出现 的 片段	d v nr v u n	演员 限定	n v
只 放 赵丽颖 的 镜头	d v nr u n	演员 限定	n v
只 放 赵丽颖 出演 的 镜头	d v nr v u n	演员 限定	n v
只 放 杨幂 出演 的 部分	d v nr v u n	演员 限定	n v
只 放 杨幂 的 戏	d v nr u n	演员 限定	n v
我 只要 看 刘亦菲 的 戏	r c v nr u n	演员 限定	n v
我 只要 看 刘亦菲 的 镜头	r c v nr u n	演员 限定	n v
我 只要 看 有 刘亦菲 出现 的 地方	r c v v nr v u n	演员 限定	n v
我 只要 看 章子怡 出现 的 部分	r c v nr v u n	演员 限定	n v
我 只要 看 有 章子怡 的 片段	r c v v nr u n	演员 限定	n v
只 看 李连杰 和 甄子丹	d v nr c nr	演员 限定	n v
只 看 李易峰 和 杨洋	d v nr c nr	演员 限定	n v
我 只 看 吴亦凡 和 鹿晗	r d v nr c nr	演员 限定	n v
我 只 看 黄子韬 和 张艺兴	r d v nr c nr	演员 限定	n v
我 只 想 看 黄渤 和 徐峥	r d v v nr c nr	演员 限定	n v
就 看 王宝强 和 黄渤	p v nr c nr	演员 限定	n v
我 只要 看 刘昊然 和 佟丽娅	r c v nr c nr	演员 限定	n v
只 看 有 林更新 和 林允儿 的 部分	d v v nr c nr u n	演员 限定	n v
只 看 林青霞 和 秦祥林	d v nr c nr	演员 限定	n v
我 只 想 看 王宝强 和 黄渤	r d v v nr c nr	演员 限定	n v
只 看 刘德华 和 梁朝伟 的 镜头	d v nr c nr u n	演员 限定	n v
只 看 陈冠希 和 余文乐 的 部分	d v nr c nr u n	演员 限定	n v
只 看 有 吴彦祖 和 成龙 的 地方	d v v nr c nr u n	演员 限定	n v
我 只要 看 周润发 和 张国荣	r c v nr c nr	演员 限定	n v
只 放 李易峰 和 杨颖 的 镜头	d v nr c nr u n	演员 限定	n v
我 只 看 杨幂 和 李易峰	r d v nr c nr	演员 限定	n v
我 只 看 魏璎珞 和 秦岚	r d v nr c nr	演员 限定	n v
南京 下周 有 雨 吗	ns t v n y	天气 查询	n v
上海 2天 是不是 雨天	ns nr nz n	天气 查询	n v
天津 今天 雨停 吗	ns t v y	天气 查询	n v
南京 有没有 雨	ns n n	天气 查询	n v
成都 雨停 吗	ns v y	天气 查询	n v
五 天 是 晴天 吗	m q v n y	天气 查询	n v
本地 是 晴天 还是 雨天	r v n c n	天气 查询	n v
长沙 明天 是不是 会 下雨	ns t nz v v	天气 查询	n v
深圳 未来 两 天 是 晴天 吗	ns t m q v n y	天气 查询	n v
成都 今天 是不是 雨天	ns t nz n	天气 查询	n v
厦门 是不是 会 下雨	ns nz v v	天气 查询	n v
长沙 今天 是 晴天 还是 雨天	ns t v n c n	天气 查询	n v
厦门 未来 两 天 是不是 晴天	ns t m q nz n	天气 查询	n v
天津 有没有 雨	ns n n	天气 查询	n v
本地 下周 是 雨天 吗	r t v n y	天气 查询	n v
南京 7月8 号 是不是 雨天	ns m q nz n	天气 查询	n v
长沙 后天 是不是 会 下雨	ns n nz v v	天气 查询	n v
厦门 后天 有 雨 吗	ns n v n y	天气 查询	n v
天津 未来 3天 雨 会 不 会 停	ns t m n v d v v	天气 查询	n v
未来 3 天 是不是 晴天	t m q nz n	天气 查询	n v
北京 明天 有没有 雨	ns t n n	天气 查询	n v
上海 7月8 号 雨 会 不 会 停	ns m q n v d v v	天气 查询	n v
成都 五 天 是不是 雨天	ns m q nz n	天气 查询	n v
深圳 有没有 雨	ns n n	天气 查询	n v
北京 是不是 晴天	ns nz n	天气 查询	n v
今天 上海 雨停 吗	t ns v y	天气 查询	n v
7月8 号 本地 有 雨 吗	m q r v n y	天气 查询	n v
2天 北京 是 雨天 吗	nr ns v n y	天气 查询	n v
2天 天津 是不是 会 下雨	nr ns nz v v	天气 查询	n v
下周 本地 是不是 晴天	t r nz n	天气 查询	n v
四月 十 号 厦门 雨 会 不 会 停	t m q ns n v d v v	天气 查询	n v
下周 厦门 是 晴天 吗	t ns v n y	天气 查询	n v
四月 十 号 有没有 雨	t m q n n	天气 查询	n v
2天 深圳 是 雨天 么	nr ns v n y	天气 查询	n v
四月 十日 重庆 有没有 雨	t t ns n n	天气 查询	n v
后天 南京 有 雨 吗	n ns v n y	天气 查询	n v
五 天 是不是 晴天	m q nz n	天气 查询	n v
今天 重庆 是 雨天 嘛	t ns v n y	天气 查询	n v
未来 两 天 是不是 晴天	t m q nz n	天气 查询	n v
五 天 广州 是不是 晴天	m q ns nz n	天气 查询	n v
2天 成都 有 雨 吗	nr ns v n y	天气 查询	n v
下周 北京 雨 会 不 会 停	t ns n v d v v	天气 查询	n v
2天 有 雨 吗	nr v n y	天气 查询	n v
重庆 雨 会 不 会 停	ns n v d v v	天气 查询	n v
2天 福州 是 晴天 么	nr ns v n y	天气 查询	n v
今天 长沙 是不是 晴天	t ns nz n	天气 查询	n v
五 天 南京 是 雨天 吗	m q ns v n y	天气 查询	n v
是 晴天 吗	v n y	天气 查询	n v
未来 两 天 天津 有没有 雨	t m q ns n n	天气 查询	n v
四月 十 号 广州 有 雨 吗	t m q ns v n y	天气 查询	n v
未来 两 天 本地 下雨 吗	t m q r v y	天气 查询	n v
后天 重庆 是不是 晴天	n ns nz n	天气 查询	n v
是不是 雨天	nz n	天气 查询	n v
四月 十 号 福州 有没有 雨	t m q ns n n	天气 查询	n v
本地 有没有 雨	r n n	天气 查询	n v
上海 今天 会 出 太阳 么	ns t v v n y	天气 查询	n v
上海 今天 会 是 晴天 么	ns t v v n y	天气 查询	n v
上海 今天 会 晴 么	ns t v v y	天气 查询	n v
北京 明天 会 出 太阳 么	ns t v v n y	天气 查询	n v
今天 深圳 会 是 晴天 么	t ns v v n y	天气 查询	n v
后天 厦门 会 晴 么	t ns v v y	天气 查询	n v
四月 十日 长沙 是不是 晴天	t t ns nz n	天气 查询	n v
未来 3 天 南京 雨 会 不 会 停	t m q ns n v d v v	天气 查询	n v
雨 会 不 会 停	n v d v v	天气 查询	n v
成都 雨 会 不 会 停	ns n v d v v	天气 查询	n v
明天 长沙 有 雨 吗	t ns v n y	天气 查询	n v
明天 重庆 雨停 吗	t ns v y	天气 查询	n v
五 天 重庆 是 晴天 吗	m q ns v n y	天气 查询	n v
2天 广州 雨 会 不 会 停	nr ns n v d v v	天气 查询	n v
后天 北京 是不是 会 下雨	n ns nz v v	天气 查询	n v
厦门 有 雨 吗	ns v n y	天气 查询	n v
未来 两 天 福州 雨 会 不 会 停	t m q ns n v d v v	天气 查询	n v
北京 是不是 会 下雨	ns nz v v	天气 查询	n v
未来 3 天 广州 雨停 吗	t m q ns v y	天气 查询	n v
有没有 雨	n n	天气 查询	n v
天津 雨停 吗	ns v y	天气 查询	n v
是不是 会 下雨 下周 北京	nz v v t ns	天气 查询	n v
是 晴天 吗 深圳	v n y ns	天气 查询	n v
是 晴天 还是 雨天 2天 长沙	v n c n nr ns	天气 查询	n v
是不是 雨天 下周 上海	nz n t ns	天气 查询	n v
是不是 雨天 成都	nz n ns	天气 查询	n v
是 晴天 还是 雨天 四月 十 号 本地	v n c n t m q r	天气 查询	n v
有没有 雨 后天 深圳	n n n ns	天气 查询	n v
是不是 晴天 四月 十 号 上海	nz n t m q ns	天气 查询	n v
有 雨 吗 今天 南京	v n y t ns	天气 查询	n v
是 雨天 吗 广州	v n y ns	天气 查询	n v
空气 质量 指数 多少	n n n r	天气 查询	n v
天津 今天 空气 质量 怎么样	ns t n n r	天气 查询	n v
天津 今天 空气 质量 指数 多少	ns t n n n r	天气 查询	n v
广州 后天 空气 怎么样	ns n n r	天气 查询	n v
成都 下周 空气 怎么样	ns t n r	天气 查询	n v
长沙 今天 空气 质量 好 吗	ns t n n a y	天气 查询	n v
本地 7月8 号 空气 质量 好 吗	r m q n n a y	天气 查询	n v
深圳 空气 质量 怎么样	ns n n r	天气 查询	n v
重庆 后天 空气 质量 指数 多少	ns n n n n r	天气 查询	n v
本地 的 空气 质量 指数	r u n n n	天气 查询	n v
天津 今天 空气 怎么样	ns t n r	天气 查询	n v
长沙 空气 质量 好 吗	ns n n a y	天气 查询	n v
本地 空气 质量 指数 多少	r n n n r	天气 查询	n v
五 天 空气 质量 怎么样	m q n n r	天气 查询	n v
四月 十日 空气 质量 指数 多少	t t n n n r	天气 查询	n v
重庆 四月 十 号 空气 质量 怎么样	ns t m q n n r	天气 查询	n v
下周 本地 空气 怎么样	t r n r	天气 查询	n v
四月 十日 重庆 空气 质量 怎么样	t t ns n n r	天气 查询	n v
明天 空气 好 吗	t n a y	天气 查询	n v
南京 的 空气 质量 指数	ns u n n n	天气 查询	n v
四月 十日 的 空气 质量 指数	t t u n n n	天气 查询	n v
下周 重庆 空气 质量 指数 多少	t ns n n n r	天气 查询	n v
下周 南京 空气 怎么样	t ns n r	天气 查询	n v
7月8 号 天津 空气 质量 指数 多少	m q ns n n n r	天气 查询	n v
北京 的 空气 质量 指数	ns u n n n	天气 查询	n v
后天 空气 质量 好 吗	n n n a y	天气 查询	n v
2天 福州 空气 怎么样	nr ns n r	天气 查询	n v
明天 本地 空气 怎么样	t r n r	天气 查询	n v
今天 长沙 空气 质量 指数 多少	t ns n n n r	天气 查询	n v
四月 十 号 广州 空气 质量 指数 多少	t m q ns n n n r	天气 查询	n v
后天 空气 质量 好 吗	n n n a y	天气 查询	n v
空气 怎么样	n r	天气 查询	n v
后天 空气 好 吗	n n a y	天气 查询	n v
上海 的 空气 质量 指数	ns u n n n	天气 查询	n v
2天 长沙 空气 质量 怎么样	nr ns n n r	天气 查询	n v
五 天 南京 空气 好 吗	m q ns n a y	天气 查询	n v
四月 十日 重庆 空气 质量 好 吗	t t ns n n a y	天气 查询	n v
下周 空气 质量 好 吗	t n n a y	天气 查询	n v
2天 福州 空气 质量 怎么样	nr ns n n r	天气 查询	n v
空气 质量 怎么样	n n r	天气 查询	n v
未来 两 天 深圳 空气 质量 好 吗	t m q ns n n a y	天气 查询	n v
空气 质量 指数	n n n	天气 查询	n v
后天 厦门 空气 质量 指数 多少	t ns n n n r	天气 查询	n v
空气 质量 怎么样	n n r	天气 查询	n v
明天 天津 空气 质量 指数 多少	t ns n n n r	天气 查询	n v
未来 3 天 长沙 空气 质量 指数 多少	t m q ns n n n r	天气 查询	n v
空气 质量 怎么样 未来 两 天 长沙	n n r t m q ns	天气 查询	n v
空气 质量 指数 多少 四月 十日 上海	n n n r t t ns	天气 查询	n v
空气 质量 好 吗 未来 两 天	n n a y t m q	天气 查询	n v
空气 好 吗	n a y	天气 查询	n v
空气 质量 怎么样	n n r	天气 查询	n v
空气 好 吗 四月 十日 深圳	n a y t t ns	天气 查询	n v
天津 四月 十日 洗 不 洗车	ns t t v d v	天气 查询	n v
北京 该 不 该 洗车	ns v d v n	天气 查询	n v
后天 能不能 洗车	n n v	天气 查询	n v
福州 2天 适 不 适合 洗车	ns nr vg d v n	天气 查询	n v
四月 十 号 适 不 适合 洗车	t m q vg d v n	天气 查询	n v
南京 今天 要不要 洗车	ns t nz v	天气 查询	n v
深圳 7月8 号 要不要 洗车	ns m q nz v	天气 查询	n v
福州 明天 的 洗车 指数	ns t u n n	天气 查询	n v
重庆 五 天 的 洗车 指数	ns m q u n n	天气 查询	n v
长沙 的 洗车 指数	ns u n n	天气 查询	n v
北京 后天 适 不 适合 洗车	ns n vg d v n	天气 查询	n v
深圳 未来 两 天 该 不 该 洗车	ns t m q v d v n	天气 查询	n v
北京 明天 的 洗车 指数	ns t u n n	天气 查询	n v
本地 洗 不 洗车	r v d v	天气 查询	n v
上海 今天 洗车 情况	ns t v n	天气 查询	n v
北京 今天 洗车 情况	ns t v n	天气 查询	n v
北京 今天 适合 洗车 吗	ns t v v n y	天气 查询	n v
上海 今天 适合 洗车 么	ns t v v n y	天气 查询	n v
明天 成都 适合 洗车 吗	ns t v v n y	天气 查询	n v
后天 长沙 适合 洗车 么	ns t v v n y	天气 查询	n v
今天 能 洗车 嘛	t v v n y	天气 查询	n v
今天 能 洗车 么	t v v n y	天气 查询	n v
今天 上海 能 洗车 么	ns t v v n y	天气 查询	n v
长沙 明天 洗 不 洗车	ns t v d v	天气 查询	n v
深圳 2天 能不能 洗车	ns nr n v	天气 查询	n v
7月8 号 适 不 适合 洗车	m q vg d v n	天气 查询	n v
四月 十日 长沙 能不能 洗车	t t ns n v	天气 查询	n v
未来 3 天 该 不 该 洗车	t m q v d v n	天气 查询	n v
7月8 号 该 不 该 洗车	m q v d v n	天气 查询	n v
南京 该 不 该 洗车	ns v d v n	天气 查询	n v
后天 成都 适 不 适合 洗车	n ns vg d v n	天气 查询	n v
2天 能不能 洗车	nr n v	天气 查询	n v
长沙 该 不 该 洗车	ns v d v n	天气 查询	n v
四月 十 号 成都 能不能 洗车	t m q ns n v	天气 查询	n v
四月 十 号 广州 能不能 洗车	t m q ns n v	天气 查询	n v
五 天 天津 要不要 洗车	m q ns nz v	天气 查询	n v
7月8 号 上海 能不能 洗车	m q ns n v	天气 查询	n v
2天 广州 适 不 适合 洗车	nr ns vg d v n	天气 查询	n v
北京 该 不 该 洗车	ns v d v n	天气 查询	n v
四月 十日 福州 的 洗车 指数	t t ns u n n	天气 查询	n v
适 不 适合 洗车	vg d v n	天气 查询	n v
2天 天津 能不能 洗车	nr ns n v	天气 查询	n v
本地 要不要 洗车	r nz v	天气 查询	n v
北京 该 不 该 洗车	ns v d v n	天气 查询	n v
今天 要不要 洗车	t nz v	天气 查询	n v
明天 能不能 洗车	t n v	天气 查询	n v
后天 福州 适 不 适合 洗车	t ns vg d v n	天气 查询	n v
洗 不 洗车	v d v	天气 查询	n v
适 不 适合 洗车	vg d v n	天气 查询	n v
五 天 上海 该 不 该 洗车	m q ns v d v n	天气 查询	n v
长沙 要不要 洗车	ns nz v	天气 查询	n v
明天 上海 洗 不 洗车	t ns v d v	天气 查询	n v
四月 十日 福州 洗 不 洗车	t t ns v d v	天气 查询	n v
洗车 指数	n n	天气 查询	n v
洗 不 洗车	v d v	天气 查询	n v
2天 天津 适 不 适合 洗车	nr ns vg d v n	天气 查询	n v
洗 不 洗车 未来 3 天	v d n t m q	天气 查询	n v
要不要 洗车 四月 十 号 成都	nz v t m q ns	天气 查询	n v
适 不 适合 洗车 今天 北京	vg d v n t ns	天气 查询	n v
南京 的 穿衣 指数	ns u v n	天气 查询	n v
五 天 穿 衣 指数	m q v ng n	天气 查询	n v
广州 怎么 穿 衣服	ns r v n	天气 查询	n v
未来 两 天 要不要 加 衣服	t m q nz v n	天气 查询	n v
天津 穿 多少	ns v r	天气 查询	n v
南京 四月 十 号 穿衣 指数	ns t m q v n	天气 查询	n v
福州 未来 两 天 怎么 穿	ns t m q r v	天气 查询	n v
福州 未来 3 天 要不要 加 衣服	ns t m q nz v n	天气 查询	n v
重庆 衣服 要不要 少 穿 一些	ns n nz ad v m	天气 查询	n v
厦门 四月 十 号 的 穿衣 指数	ns t m q u v n	天气 查询	n v
本地 未来 3 天 要不要 加 衣服	r t m q nz v n	天气 查询	n v
2天 的 穿衣 指数	nr u v n	天气 查询	n v
五 天 穿 什么 衣服	m q v r n	天气 查询	n v
厦门 7月8 号 衣服 要不要 少 穿 一些	ns m q n nz ad v m	天气 查询	n v
今天穿什么 衣服	nz n	天气 查询	n v
今天穿什么	nz	天气 查询	n v
今天穿什么 上海	nz ns	天气 查询	n v
广州 五 天 衣服 要不要 少 穿 一些	ns m q n nz ad v m	天气 查询	n v
穿衣 指数	v n	天气 查询	n v
厦门 后天 的 穿衣 指数	ns n u v n	天气 查询	n v
福州 2天 穿 多少	ns nr v r	天气 查询	n v
深圳 未来 3 天 要不要 加 衣服	ns t m q nz v n	天气 查询	n v
福州 穿 多少 合适	ns v r a	天气 查询	n v
天津 四月 十 号 穿衣 指数	ns t m q v n	天气 查询	n v
重庆 2天 穿 多少 合适	ns nr v r a	天气 查询	n v
成都 怎么 穿 衣服	ns r v n	天气 查询	n v
四月 十 号 长沙 怎么 穿 衣服	t m q ns r v n	天气 查询	n v
厦门 穿 什么	ns v r	天气 查询	n v
7月8 号 福州 要不要 加 衣服	m q ns nz v n	天气 查询	n v
成都 穿 多少 合适	ns v r a	天气 查询	n v
7月8 号 天津 要不要 加 衣服	m q ns nz v n	天气 查询	n v
今天 重庆 穿衣 指数	t ns v n	天气 查询	n v
今天 上海 穿衣 情况	t ns v n	天气 查询	n v
上海 今天 穿衣 情况	ns t v n	天气 查询	n v
下周 二 太原 穿衣 情况	t m ns v n	天气 查询	n v
春节 盐城 穿衣 情况	t ns v n	天气 查询	n v
周日 大庆 穿衣 情况	t ns v n	天气 查询	n v
一月 一 号 常州 穿衣 情况	t m q ns v n	天气 查询	n v
未来 五 天 济宁 穿衣 情况	t m q ns v n	天气 查询	n v
清明 南宁 穿衣 情况	t ns v n	天气 查询	n v
一月 一 号 嘉兴 穿衣 情况	t m q ns v n	天气 查询	n v
枣庄 穿衣 情况	ns v n	天气 查询	n v
嘉兴 穿衣 情况	ns v n	天气 查询	n v
芜湖 穿衣 情况	ns v n	天气 查询	n v
宿迁 穿衣 情况	ns v n	天气 查询	n v
太原 穿衣 情况	ns v n	天气 查询	n v
常德 穿衣 情况	ns v n	天气 查询	n v
武汉 穿衣 情况	ns v n	天气 查询	n v
天气预报	n	天气 查询	n v
天气预报	n	天气 查询	n v
四月 十日 穿什么 合适	t t l a	天气 查询	n v
四月 十 号 上海 要不要 加 衣服	t m q ns nz v n	天气 查询	n v
下周 天津 要不要 加 衣服	t ns nz v n	天气 查询	n v
下周 深圳 穿什么 衣服	t ns l n	天气 查询	n v
天津 的 穿衣 指数	ns u v n	天气 查询	n v
广州 衣服 要不要 少 穿 一些	ns n nz ad v m	天气 查询	n v
本地 穿 多少 合适	r v r a	天气 查询	n v
南京 穿 多少	ns v r	天气 查询	n v
今天 长沙 怎么 穿 衣服	t ns r v n	天气 查询	n v
明天 穿衣 指数	t v n	天气 查询	n v
今天 成都 怎么 穿 衣服	t ns r v n	天气 查询	n v
未来 3 天 广州 穿衣 指数	t m q ns v n	天气 查询	n v
今天 要不要 加 衣服	t nz v n	天气 查询	n v
天津 怎么 穿	ns r v	天气 查询	n v
7月8 号 广州 穿什么 合适	m q ns l a	天气 查询	n v
2天 上海 衣服 要不要 少 穿 一些	nr ns n nz ad v m	天气 查询	n v
广州 穿 什么 衣服	ns v r n	天气 查询	n v
本地 的 穿衣 指数	r u v n	天气 查询	n v
穿什么 今天	l t	天气 查询	n v
穿衣 指数	v n	天气 查询	n v
重庆 穿 什么 衣服	ns v r n	天气 查询	n v
的 穿衣 指数	u v n	天气 查询	n v
下周 福州 衣服 要不要 少 穿 一些	t ns n nz ad v m	天气 查询	n v
下周 穿衣 指数	t v n	天气 查询	n v
厦门 要不要 加 衣服	ns nz v n	天气 查询	n v
7月8 号 长沙 衣服 要不要 少	m q ns n nz ad	天气 查询	n v
下周 穿 多少 合适	t v r a	天气 查询	n v
怎么 穿	r v	天气 查询	n v
福州 穿什么 合适	ns l a	天气 查询	n v
四月 十日 长沙 怎么 穿 衣服	t t ns r v n	天气 查询	n v
五 天 天津 穿什么 衣服	m q ns l n	天气 查询	n v
四月 十日 福州 怎么 穿 衣服	t t ns r v n	天气 查询	n v
今天 天津 穿 多少 合适	t ns v r a	天气 查询	n v
未来 两 天 厦门 怎么 穿 衣服	t m q ns r v n	天气 查询	n v
四月 十 号 厦门 要不要 加 衣服	t m q ns nz v n	天气 查询	n v
未来 两 天 要不要 加 衣服	t m q nz v n	天气 查询	n v
下周 本地 穿衣 指数	t r v n	天气 查询	n v
未来 3 天 深圳 穿什么 衣服	t m q ns l n	天气 查询	n v
南京 衣服 要不要 少 穿 一些	ns n nz ad v m	天气 查询	n v
2天 北京 的 穿衣 指数	nr ns u v n	天气 查询	n v
穿什么 衣服 7月8 号 本地	l n m q r	天气 查询	n v
怎么 穿 衣服 后天	r v n n	天气 查询	n v
穿什么 合适 后天 重庆	l a n ns	天气 查询	n v
穿 多少 合适 四月 十日 福州	v r a t t ns	天气 查询	n v
衣服 要不要 少 穿 一些 7月8 号	n nz ad v m m q	天气 查询	n v
要不要 加 衣服 北京	nz v n ns	天气 查询	n v
怎么 穿 衣服 2天 福州	r v n nr ns	天气 查询	n v
穿 多少 合适 2天 重庆	v r a nr ns	天气 查询	n v
穿 多少 合适 后天 成都	v r a n ns	天气 查询	n v
穿什么 合适 明天	l a t	天气 查询	n v
重庆 2天 紫外线 指数 多少	ns nr n n r	天气 查询	n v
长沙 五 天 紫外线 指数 多少	ns m q n n r	天气 查询	n v
广州 的 紫外线 指数 是 多少	ns u n n v r	天气 查询	n v
广州 明天 紫外线 指数 多少	ns t n n r	天气 查询	n v
长沙 四月 十日 紫外线 强 吗	ns t t n a y	天气 查询	n v
长沙 紫外线 指数 多少	ns n n r	天气 查询	n v
成都 四月 十 号 的 紫外线 指数 是 多少	ns t m q u n n v r	天气 查询	n v
未来 两 天 紫外线 强 么	t m q n a y	天气 查询	n v
南京 今天 的 紫外线 指数 是 多少	ns t u n n v r	天气 查询	n v
今天 紫外线 强 嘛	t n a y	天气 查询	n v
成都 下周 紫外线 指数 多少	ns t n n r	天气 查询	n v
南京 未来 两 天 紫外线 强 吗	ns t m q n a y	天气 查询	n v
深圳 四月 十 号 紫外线 强 吗	ns t m q n a y	天气 查询	n v
福州 紫外线 指数 多少	ns n n r	天气 查询	n v
深圳 四月 十 号 的 紫外线 指数 是 多少	ns t m q u n n v r	天气 查询	n v
福州 四月 十日 紫外线 强 吗	ns t t n a y	天气 查询	n v
未来 3 天 深圳 的 紫外线 指数 是 多少	t m q ns u n n v r	天气 查询	n v
四月 十 号 的 紫外线 指数 是 多少	t m q u n n v r	天气 查询	n v
未来 3 天 长沙 紫外线 强 吗	t m q ns n a y	天气 查询	n v
五 天 成都 紫外线 指数 多少	m q ns n n r	天气 查询	n v
下周 北京 紫外线 指数 多少	t ns n n r	天气 查询	n v
四月 十 号 深圳 紫外线 指数 多少	t m q ns n n r	天气 查询	n v
今天 南京 紫外线 强 嘛	t ns n a y	天气 查询	n v
今天 紫外线 强 么	t n a y	天气 查询	n v
上海 紫外线 指数 多少	ns n n r	天气 查询	n v
的 紫外线 指数 是 多少	u n n v r	天气 查询	n v
明天 紫外线 指数 多少	t n n r	天气 查询	n v
四月 十日 紫外线 强 吗	t t n a y	天气 查询	n v
2天 深圳 紫外线 指数 多少	nr ns n n r	天气 查询	n v
五 天 深圳 紫外线 指数 多少	m q ns n n r	天气 查询	n v
下周 厦门 紫外线 指数 多少	t ns n n r	天气 查询	n v
今天 紫外线 强 吗	t n a y	天气 查询	n v
未来 两 天 的 紫外线 指数 是 多少	t m q u n n v r	天气 查询	n v
今天 南京 紫外线 指数 多少	t ns n n r	天气 查询	n v
2天 厦门 的 紫外线 指数 是 多少	nr ns u n n v r	天气 查询	n v
下周 紫外线 强 吗	t n a y	天气 查询	n v
下周 本地 紫外线 强 嘛	t r n a y	天气 查询	n v
四月 十 号 深圳 紫外线 指数 多少	t m q ns n n r	天气 查询	n v
四月 十 号 深圳 紫外线 指数 多少	t m q ns n n r	天气 查询	n v
7月8 号 的 紫外线 指数 是 多少	m q u n n v r	天气 查询	n v
紫外线 指数 多少 2天 上海	n n r nr ns	天气 查询	n v
紫外线 强 么 未来 3 天 上海	n a y t m q ns	天气 查询	n v
紫外线 指数 多少 明天 北京	n n r t ns	天气 查询	n v
黄金瞳 的 主演 是 谁	nr u n v r	演员 查询	n v
怒晴湘西 的 主演 是 谁	nz u n v r	演员 查询	n v
皓镧传 的 主演 是 谁	nz u n v r	演员 查询	n v
独孤 皇后 的 主演 是 谁	n n u n v r	演员 查询	n v
知否知否应是绿肥红瘦 的 主演 是 谁	nz u n v r	演员 查询	n v
逆流 而 上 的 你 的 主演 是 谁	n c f u r u n v r	演员 查询	n v
招摇 的 主演 是 谁	v u n v r	演员 查询	n v
鬼吹灯 的 主演 是 谁	n u n v r	演员 查询	n v
小女花不弃 的 主演 是 谁	nz u n v r	演员 查询	n v
地久天长 的 主演 是 谁	nz u n v r	演员 查询	n v
斗破苍穹 的 主演 是 谁	nz u n v r	演员 查询	n v
天下无诈 的 主演 是 谁	nz u n v r	演员 查询	n v
逆 水寒 的 主演 是 谁	vg nr u n v r	演员 查询	n v
我在大理寺当宠物 的 主演 是 谁	nz u n v r	演员 查询	n v
一吻定情 的 主演 是 谁	nz u n v r	演员 查询	n v
红楼梦 的 主演 是 谁	nz u n v r	演员 查询	n v
天眼 的 主演 是 谁	nz u n v r	演员 查询	n v
香蜜沉沉烬如霜 的 主演 是 谁	nz u n v r	演员 查询	n v
延禧攻略 的 主演 是 谁	nz u n v r	演员 查询	n v
如懿传 的 主演 是 谁	nz u n v r	演员 查询	n v
微微一笑很倾城 的 主演 是 谁	nz u n v r	演员 查询	n v
武动乾坤 的 主演 是 谁	nz u n v r	演员 查询	n v
十年三月三十日 的 主演 是 谁	nz u n v r	演员 查询	n v
触及 真心 的 主演 是 谁	v n u n v r	演员 查询	n v
镇魂 的 主演 是 谁	nz u n v r	演员 查询	n v
步步惊心 的 主演 是 谁	nz u n v r	演员 查询	n v
爱情公寓 的 主演 是 谁	nz u n v r	演员 查询	n v
父母爱情 的 主演 是 谁	nz u n v r	演员 查询	n v
大江 大 河 的 主演 是 谁	nr a n u n v r	演员 查询	n v
古董局中局 的 主演 是 谁	nz u n v r	演员 查询	n v
琅琊榜 的 主演 是 谁	nz u n v r	演员 查询	n v
神雕侠侣 的 主演 是 谁	nz u n v r	演员 查询	n v
秦始皇 的 主演 是 谁	nz u n v r	演员 查询	n v
射雕英雄传 的 主演 是 谁	nz u n v r	演员 查询	n v
天衣无缝 的 主演 是 谁	nz u n v r	演员 查询	n v
三生三世十里桃花 的 主演 是 谁	nz u n v r	演员 查询	n v
猫和老鼠 的 主演 是 谁	nz u n v r	演员 查询	n v
我爱我家 的 主演 是 谁	nz u n v r	演员 查询	n v
人民的名义 的 主演 是 谁	nz u n v r	演员 查询	n v
天龙八部 的 主演 是 谁	nz u n v r	演员 查询	n v
白夜追凶 的 主演 是 谁	nz u n v r	演员 查询	n v
倚天屠龙记 的 主演 是 谁	nz u n v r	演员 查询	n v
我的奇妙男友 的 主演 是 谁	nz u n v r	演员 查询	n v
水浒传 的 主演 是 谁	nz u n v r	演员 查询	n v
请回答1988 的 主演 是 谁	nz u n v r	演员 查询	n v
笑傲江湖 的 主演 是 谁	nz u n v r	演员 查询	n v
惊蛰 的 主演 是 谁	nr u n v r	演员 查询	n v
将夜 的 主演 是 谁	nz u n v r	演员 查询	n v
甄嬛传 的 主演 是 谁	nz u n v r	演员 查询	n v
盗墓笔记 的 主演 是 谁	nz u n v r	演员 查询	n v
皇后 的 品格 的 主演 是 谁	n u n u n v r	演员 查询	n v
仙剑奇侠传3 的 主演 是 谁	nz u n v r	演员 查询	n v
限行 么 上海	v y ns	限行 查询	v v
上海 明天 最 高 温度	ns t d a n	天气 查询	n v
开讲啦 谁 导演 的	nz r v u	导演 查询	n v
电影 感动 中国 的 导演 是 谁	n v ns u n v r	导演 查询	n v
电影 我爱我家 的 编剧 是 谁	n nz u n v r	导演 查询	n v
电影 我爱我家 的 制片人 是 谁	n nz u n v r	导演 查询	n v
电影 红楼梦 的 导演 是 谁	n nz u n v r	导演 查询	n v
电影 微微一笑很倾城 的 编剧 是 谁	n nz u n v r	导演 查询	n v
电影 我的奇妙男友 的 制片人 是 谁	n nz u n v r	导演 查询	n v
逆 水寒 的 导演 是 谁 了	vg nr u n v r y	导演 查询	n v
欢乐喜剧人 的 导演 是 哪个 呢	nz u n v r y	导演 查询	n v
电影 步步惊心 的 导演 是 谁	n nz u n v r	导演 查询	n v
谁 拍 的 陈翔六点半	r v u nz	导演 查询	n v
电视剧 快乐大本营 的 导演 是 谁	n nz u n v r	导演 查询	n v
韩剧 触及 真心 导演 是 谁	n v d n v r	导演 查询	n v
圆桌派 是 哪个 作品 嘛	nz v r n y	导演 查询	n v
三生三世十里桃花 导演 是 谁	nz n v r	导演 查询	n v
新 拍 的 电视剧 知否知否应是绿肥红瘦 导演 是 谁 啊	a ng u n nz n v r y	导演 查询	n v
将夜 导演 是 谁	nz n v r	导演 查询	n v
小女花不弃 的 导演	nz u n	导演 查询	n v
皓镧传 是 哪个 导演 拍 的	nz v r n v u	导演 查询	n v
奔跑吧兄弟 的 导演 是 谁 啊	nz u n v r y	导演 查询	n v
陈翔六点半 导演 是 谁	nz n v r	导演 查询	n v
独孤皇后 导演 是 谁	nz n v r	导演 查询	n v
我的奇妙男友 导演 是 谁	nz n v r	导演 查询	n v
盗墓笔记 的 导演 是 谁	nz u n v r	导演 查询	n v
歌手 2018 谁 导 的	nz m r vg u	导演 查询	n v
逆流 而 上 的 你 是 由 谁 导 的	n c f u r v p r vg u	导演 查询	n v
跨越 导演 是 谁	v n v r	导演 查询	n v
妻子的浪漫旅行 导演 是 谁 啊	nz n v r y	导演 查询	n v
谁 导 的 天下无诈	r vg u nz	导演 查询	n v
电影 声入人心 的 导演 是 谁	n nz u n v r	导演 查询	n v
中国情歌汇 导演	nz n	导演 查询	n v
黄金瞳 的 导演	nr u n	导演 查询	n v
电影 开学第一课 的 导演 是	n nz u n v	导演 查询	n v
晓说 电视剧 导演 是 谁	nz n n v r	导演 查询	n v
87 版 声入人心 的 导演 是 谁	m n nz u n v r	导演 查询	n v
我 想 知道 白夜追凶 的 导演 是 谁	r v v nz u n v r	导演 查询	n v
动漫 的 导演	v u n	导演 查询	n v
天龙八部 导演 叫 什么	nz n v r	导演 查询	n v
我爱我家 导演 是 谁	nz n v r	导演 查询	n v
微微一笑很倾城 的 导演 的 名字 叫	nz u n u n v	导演 查询	n v
最强大脑 的 导演 叫 什么	nz u n v r	导演 查询	n v
开学第一课 是 谁 导演 的 呢	nz v r v u y	导演 查询	n v
新视觉 的 导演 是 谁	nz u n v r	导演 查询	n v
这 部 片 是 谁 导演 的	r q ng v r n u	导演 查询	n v
触及 真心 的 导演	v n u n	导演 查询	n v
我爱我家 的 导演 叫 什么	nz u n v r	导演 查询	n v
是 谁 导 的 爸爸去哪儿 名单	v r vg u nz n	导演 查询	n v
谁 是 这 片 的 导演	r v r q u n	导演 查询	n v
我 想 知道 导演 是 谁	r v v n v r	导演 查询	n v
步步惊心 导演 是 谁 呢	nz n v r y	导演 查询	n v
王牌对王牌第三季 的 导演 是 哪个	nz u n v r	导演 查询	n v
挑战不可能 的 导演	nz u n	导演 查询	n v
妻子的浪漫旅行 导演	nz n	导演 查询	n v
知否知否应是绿肥红瘦 是 谁 拍 的	nz v r v u	导演 查询	n v
偶像练习生 导演 是 谁	nz n v r	导演 查询	n v
开讲啦 导演	nz n	导演 查询	n v
如懿传 的 导演	nz u n	导演 查询	n v
流淌的歌声 的 导演	nz u n	导演 查询	n v
王牌对王牌第三季 的 导演	nz u n	导演 查询	n v
电影 重量级 改变 的 导演	n b v u n	导演 查询	n v
王牌对王牌第三季 电影 的 导演	nz n u n	导演 查询	n v
三生三世十里桃花 的 主演 是 谁	nz u n v r	演员 查询	n v
冒险片 水浒传 谁 主演	n nz r v	演员 查询	n v
我在大理寺当宠物 唐嫣 的 扮演者	nz nr u n	演员 查询	n v
爱情公寓 谁 主演 啊 大陆 版 的	nz r v y n n u	演员 查询	n v
皇后 的 品格 行里 刘昊然 是 谁 扮演 的	n u n n nr v r v u	演员 查询	n v
我是歌手 谁 主演 的	nz r v u	演员 查询	n v
电影 动漫 里面 的 许志安 谁 演 的	n n f u nr r v u	演员 查询	n v
演 我爱我家 男声 是 谁	v nz n v r	演员 查询	n v
晓说 是 谁 主演	nz v r v	演员 查询	n v
奔跑 吧 的 男女 主角	v y u n n	演员 查询	n v
最强大脑 的 主演 是 谁	nz u n v r	演员 查询	n v
奔跑吧兄弟 男主角 是 谁	nz n v r	演员 查询	n v
笑傲江湖 的 男主角 是 谁 扮演 的	nz u n v r v u	演员 查询	n v
小女花不弃 郑爽 小 演员 的 扮演者	nz nr a n u n	演员 查询	n v
黄金瞳 扮演 朱亚文 的 演员	nr v nr u n	演员 查询	n v
妻子的浪漫旅行 的 主演 是 谁	nz u n v r	演员 查询	n v
青春 有 你 女主角 叫 什么	n v r n v r	演员 查询	n v
拍 倚天屠龙记 的 女 主叫 什么	v nz u b v r	演员 查询	n v
爸爸去哪儿 是 谁 主演	nz v r v	演员 查询	n v
电影 歌手 2018 是 谁 主演	n nz m v r v	演员 查询	n v
我爱我家 是 谁 演 的	nz v r v u	演员 查询	n v
重量级 改变 的 主演 是 谁	b v u n v r	演员 查询	n v
最强大脑 是 谁 主演	nz v r v	演员 查询	n v
白夜追凶 电影 谁 主演 的	nz n r v u	演员 查询	n v
我的奇妙男友 这 部 电影 是 谁 主演 的	nz r q n v r v u	演员 查询	n v
电影 天天向上 的 主演 是 哪个	n nz u n v r	演员 查询	n v
微微一笑很倾城 的 主演 是 谁	nz u n v r	演员 查询	n v
电视剧 锋味 谁 主演	n nz r v	演员 查询	n v
开讲啦 男主角	nz n	演员 查询	n v
青春 有 你 中 的 黄明昊 是 谁 演 的	n v r f u nr v r v u	演员 查询	n v
王牌对王牌 的 女主角 叫 什么	nz u n v r	演员 查询	n v
歌手 2018 里 的 男主角 叫 什么	nz m f u n v r	演员 查询	n v
向往的生活 电影 女主角 叫 什么	nz n n v r	演员 查询	n v
圆桌派 谁 演 景甜	nz r v nr	演员 查询	n v
锋味 张柏芝 扮演者 是 谁	nz nr n v r	演员 查询	n v
一吻定情 郑爽 的 扮演者 是	nz nr u n v	演员 查询	n v
电影 天眼 演员 名字	n nz n n	演员 查询	n v
智慧树 谁 主演	nz r v	演员 查询	n v
新视觉 的 主演 是 谁	nz u n v r	演员 查询	n v
声入人心 中 张丹峰 精灵王 是 谁 演 的	nz f nr n v r v u	演员 查询	n v
琅琊榜 中 的 女主角 是 谁	nz f u n v r	演员 查询	n v
秦始皇 的 演员 是 谁	nz u n v r	演员 查询	n v
爸爸去哪儿 是 谁 主演 的	nz v r v u	演员 查询	n v
极限挑战 中 郑秀文 是 谁 演 的	nz f nr v r v u	演员 查询	n v
鬼吹灯 主演 都 有 谁	n n d v r	演员 查询	n v
火星情报局 郭德纲 的 扮演者	nz nr u n	演员 查询	n v
盗墓笔记 的 主演 谁 啊	nz u n r y	演员 查询	n v
武动乾坤 电影 中 饰演 吴彦祖 的 是 谁 啊	nz n f v nr u v r y	演员 查询	n v
天下足球 的 演员	nz u n	演员 查询	n v
仙剑奇侠传3 主演 都 是 谁	nz n d v r	演员 查询	n v
琅琊榜 斯嘉丽约翰逊 的 扮演者	nz nr u n	演员 查询	n v
创造101 谁 是 主演	nz r v n	演员 查询	n v
快乐大本营 是 谁 主演 的 啊	nz v r v u y	演员 查询	n v
仙剑奇侠传3 里 石原里美 是 谁 演 的	nz f nr v r v u	演员 查询	n v
智慧树 王俊凯 是 谁 主演	nz nr v r v	演员 查询	n v
天天向上 的 女主角 叫 什么 名字	nz u n v r n	演员 查询	n v
我是歌手 的 主演 是 谁	nz u n v r	演员 查询	n v
我爱我家 的 是 谁 主演 的	nz u v r v u	演员 查询	n v
我的奇妙男友 的 主演 有 哪些 人	nz u n v r n	演员 查询	n v
将 夜 的 男主角 是 谁 啊	p tg u n v r y	演员 查询	n v
谁 是 十年三月三十日 的 女主角	r v nz u n	演员 查询	n v
惊蛰 的 主演 有 哪些 啊	nr u n v r y	演员 查询	n v
能 告诉 我 明星大侦探 的 主要 演员 么	v v r nz u b n y	演员 查询	n v
最 新 延禧攻略 的 主演 有 谁 啊	d a nz u n v r y	演员 查询	n v
白夜追凶 的 主演	nz u n	演员 查询	n v
百家讲坛 的 男 主叫 什么 啊	nz u b v r y	演员 查询	n v
奔跑 吧 的 女 主叫 啥 呢	v y u b v r y	演员 查询	n v
德云社 男 主 是 谁	nz b bg v r	演员 查询	n v
开学第一课 的 男 主叫 什么	nz u b v r	演员 查询	n v
白夜追凶 男 主 是 谁	nz b bg v r	演员 查询	n v
靳东 是 谁 扮演 的	nr v r v u	演员 查询	n v
爱情公寓 的 男主角 是 谁	nz u n v r	演员 查询	n v
谁 是 延禧攻略 的 女 主	r v nz u b n	演员 查询	n v
流淌的歌声 的 女 主 是 谁	nz u b n v r	演员 查询	n v
百家讲坛 女 猪脚 有 哪些	nz b n v r	演员 查询	n v
倚天屠龙记 的 主演 都 有 谁	nz u n d v r	演员 查询	n v
流淌的歌声 的 主演	nz u n	演员 查询	n v
爱情公寓 主角	nz n	演员 查询	n v
香蜜沉沉烬如霜 的 主演	nz u n	演员 查询	n v
重量级 改变 的 男女 主角	b v u n n	演员 查询	n v
偶像练习生 上 的 女 主 是 谁	nz f u b n v r	演员 查询	n v
怒晴湘西 的 男 主 有 哪些	nz u b bg v r	演员 查询	n v
中国诗词大会 的 主演	nz u n	演员 查询	n v
大江 大 河 的 主演 是 谁	nr a n u n v r	演员 查询	n v
逆 水寒 的 女 主叫 什么 名字	vg nr u b v r n	演员 查询	n v
谁 是 阿黛尔 的 老公	r v nr u n	明星 关系 查询	n n v
谁 是 陈晓 的 同学	r v nr u n	明星 关系 查询	n n v
石原里美 的 好友 有 哪些	nr u n v r	明星 关系 查询	n n v
彭于晏 的 同学 有 哪些	nr u n v r	明星 关系 查询	n n v
哪些 人 是 张嘉倪 的 好 朋友	r n v nr u a n	明星 关系 查询	n n v
张丹峰 的 好友 有 哪些 人	nr u n v r n	明星 关系 查询	n n v
田馥甄 的 好友	nr u n	明星 关系 查询	n n v
海陆 的 前男友 是 哪个	nr u n v r	明星 关系 查询	n n v
李易峰 的 圈 内 朋友 有 哪些	nr u n f n v r	明星 关系 查询	n n v
刘诗诗 的 圈 内 好友	nr u n f n	明星 关系 查询	n n v
戚薇 的 老婆 是 谁	nr u n v r	明星 关系 查询	n n v
周星驰 老婆	nr n	明星 关系 查询	n n v
柳岩 的 老婆 叫 什么	nr u n v r	明星 关系 查询	n n v
张钧甯 老婆 的 名字	nr n u n	明星 关系 查询	n n v
薛之谦 同学 的 名字	nr n u n	明星 关系 查询	n n v
张丹峰 前 女友 是 谁 啊	nr f n v r y	明星 关系 查询	n n v
木村拓哉 的 老公 是 谁	nr u n v r	明星 关系 查询	n n v
胡海峰 丈夫 是 哪个	nr n v r	明星 关系 查询	n n v
邓紫棋 的 女儿 叫 什么 呢	nr u n v r y	明星 关系 查询	n n v
彭于晏 的 男朋友 是 谁	nr u n v r	明星 关系 查询	n n v
海陆 的 绯闻男友 有 哪些	nr u n v r	明星 关系 查询	n n v
谁 和 王祖贤 合作 过	r c nr v u	明星 关系 查询	n n v
谁 和 戚薇 合作 过	r c nr v u	明星 关系 查询	n n v
谁 和 李钟硕 合作 过	r c nr v u	明星 关系 查询	n n v
谁 是 胡歌 的 老搭档	r v nr u n	明星 关系 查询	n n v
许志安 和 哪些 人 合作 过	nr c r n v u	明星 关系 查询	n n v
彭于晏 和 谁 是 搭档	nr c r v n	明星 关系 查询	n n v
李晨 未来 3 天 的 搭档 是 谁	nr t m q u n v r	明星 关系 查询	n n v
唐嫣 和 谁 合作 最 多	nr c r v d a	明星 关系 查询	n n v
唐嫣 和 谁 合作 过	nr c r v u	明星 关系 查询	n n v
陈楚生 下周 二 男友 是 谁	nr t m n v r	明星 关系 查询	n n v
杨紫 的 女朋友 是 那个	nr u n v r	明星 关系 查询	n n v
佟丽娅 的 女友 是 谁 啊	nr u n v r y	明星 关系 查询	n n v
谁 是 华晨宇 的 绯闻 女友	r v nr u n n	明星 关系 查询	n n v
谁 是 王丽坤 的 好 朋友	r v nr u a n	明星 关系 查询	n n v
周笔畅 的 朋友 有 哪些	nr u n v r	明星 关系 查询	n n v
欧阳娜娜 的 好友	nr u n	明星 关系 查询	n n v
郑秀文 的 老师	nr u n	明星 关系 查询	n n v
沈腾 的 同学	nr u n	明星 关系 查询	n n v
王祖贤 的 老婆	nr u n	明星 关系 查询	n n v
张丹峰 的 妻子 是 谁	nr u n v r	明星 关系 查询	n n v
朱一龙 女儿 叫 什么	nr n v r	明星 关系 查询	n n v
王丽坤 的 老公 是 谁 呢	nr u n v r y	明星 关系 查询	n n v
汪峰 的 老公 是 哪个 啊	nr u n v r y	明星 关系 查询	n n v
薛之谦 的 老公 的 名字 是	nr u n u n v	明星 关系 查询	n n v
郭德纲 和 儿子 叫 什么	nr c n v r	明星 关系 查询	n n v
我 想 知道 胡歌 的 老公 叫 啥	r v v nr u n v r	明星 关系 查询	n n v
王彦霖 的 妻子 叫 啥 呢	nr u n v r y	明星 关系 查询	n n v
你 知道 薛之谦 的 老婆 叫 什么 吗	r v nr u n v r y	明星 关系 查询	n n v
吴磊 的 老婆 是 谁	nr u n v r	明星 关系 查询	n n v
谁 是 林允儿 的 前 女友	r v nr u f n	明星 关系 查询	n n v
李晨 老婆 叫 什么 名字 啊	nr n v r n y	明星 关系 查询	n n v
张子枫 的 男友 是 谁 啊	nr u n v r y	明星 关系 查询	n n v
黄渤 老婆 叫 什么 啊	nr n v r y	明星 关系 查询	n n v
贾乃亮 的 老婆 叫 什么 啊	nr u n v r y	明星 关系 查询	n n v
李敏镐 的 老婆 叫 什么 呢	nr u n v r y	明星 关系 查询	n n v
黄渤 的 女友 是 谁 啊	nr u n v r y	明星 关系 查询	n n v
木村拓哉 女友 是 谁 呢	nr n v r y	明星 关系 查询	n n v
谁 是 张紫妍 男友 呢	r v nr n y	明星 关系 查询	n n v
谁 是 李小冉 同学 呢	r v nr n y	明星 关系 查询	n n v
谁 是 胡歌 的 老师 啊	r v nr u n y	明星 关系 查询	n n v
告诉 我 张馨予 的 前男友 是 谁 吧	v r nr u n v r y	明星 关系 查询	n n v
王源 女朋友 是 谁	nr n v r	明星 关系 查询	n n v
周笔畅 老婆 是 谁	nr n v r	明星 关系 查询	n n v
谁 是 窦骁 女朋友	r v nr n	明星 关系 查询	n n v
谁 是 田馥甄 前 女友	r v nr f n	明星 关系 查询	n n v
谁 是 杨紫 男朋友	r v nr n	明星 关系 查询	n n v
古力娜扎 男友 是 谁	nr n v r	明星 关系 查询	n n v
鹿晗 女友 是 谁 啊	nr n v r y	明星 关系 查询	n n v
谁 是 沈腾 的 老婆	r v nr u n	明星 关系 查询	n n v
哪些 人 是 宋祖儿 的 圈 内 好友	r n v nr u n f n	明星 关系 查询	n n v
谁 是 阿黛尔 的 前 女友	r v nr u f n	明星 关系 查询	n n v
邓紫棋 老公 是 谁	nr n v r	明星 关系 查询	n n v
谁 是 杨幂 老公 啊	r v nr n y	明星 关系 查询	n n v
海陆 的 老公 叫 什么	nr u n v r	明星 关系 查询	n n v
王彦霖 的 老公 叫 啥	nr u n v r	明星 关系 查询	n n v
向佐 的 老公 叫 什么 呢	nr u n v r y	明星 关系 查询	n n v
谁 是 胡海峰 老公 啊	r v nr n y	明星 关系 查询	n n v
天气 怎么样	n r	天气 查询	n v
乌鲁木齐 一直 下雨	ns d v	天气 查询	n v
绍兴 有 冰雹 天气	ns v n n	天气 查询	n v
湖州 又 大暴雨	ns d n	天气 查询	n v
佛山   天气 怎样	ns w n r	天气 查询	n v
枣庄 下周 都 有 雨 吗	ns t d v n y	天气 查询	n v
昆明 周五 高温	ns t n	天气 查询	n v
东莞 中秋 阴天 吗	ns t n y	天气 查询	n v
滨州 现在 有 雨 吗	ns t v n y	天气 查询	n v
下周 六 是 晴天 吗	t m v n y	天气 查询	n v
常州 十二月 二十 号 有 大风 吗	ns t m q v n y	天气 查询	n v
唐山 三 天 会 有 大雾 吗	ns m q v v n y	天气 查询	n v
泉州 2月10 号 左右 有 雨夹雪 吗	ns m q m v n y	天气 查询	n v
10月24日 空气 适合 跑步 吗	t n v v y	天气 查询	n v
适合 穿 短裤 吗	v v n y	天气 查询	n v
国庆节 适合 穿 什么	t v v r	天气 查询	n v
周日 能 洗 车 吗	t v v n y	天气 查询	n v
6月1日 天气 适合 外出 打球	t n v v v	天气 查询	n v
春节 天气 可以 去 故宫 旅游 吗	t n v v ns vn y	天气 查询	n v
5 号 天气 容易 导致 感冒 吗	m q n a v v y	天气 查询	n v
天气 好 吗	n a y	天气 查询	n v
淮安 下雨 吗	ns v y	天气 查询	n v
南京 晴天	ns n	天气 查询	n v
泰安 高温	ns n	天气 查询	n v
贵阳 阴天	ns n	天气 查询	n v
郑州 明天 下 了 一 天雨	ns t v u m nr	天气 查询	n v
苏州 四月 十 号 很 热	ns t m q d k	天气 查询	n v
廊坊 周末 高温 吗	ns t n y	天气 查询	n v
武汉 三 天 阴天 吗	ns m q n y	天气 查询	n v
哈尔滨 周末 晴天 吗	ns t n y	天气 查询	n v
宁波 下周 二 有 雨 吗	ns t m v n y	天气 查询	n v
乌鲁木齐 下雪 了 吗	ns v y y	天气 查询	n v
菏泽 大雨 吗	ns n y	天气 查询	n v
菏泽 下雪 吗	ns n y	天气 查询	n v
嘉兴 春节 冷 吗	ns t a y	天气 查询	n v
淮安   都 是 阴天	ns w d v n	天气 查询	n v
合肥 这个 礼拜 晴天 吗	ns r n n y	天气 查询	n v
包头 今天 有点 冷	ns t d a	天气 查询	n v
重庆 今天 晚上 是 阴天	ns t t v n	天气 查询	n v
沧州 一直 下雨 吧	ns d v y	天气 查询	n v
漳州 有 大雾 吗	ns v n y	天气 查询	n v
周日 的 天气	t u n	天气 查询	n v
周五 天气	t n	天气 查询	n v
周末 下雨 吗	t v y	天气 查询	n v
明天 下 不 下雨 啊	t f d v y	天气 查询	n v
常州 明天 天气	ns t n	天气 查询	n v
下雨 吗 下 周四	v y f t	天气 查询	n v
这个 礼拜 天气 怎么样	r n n r	天气 查询	n v
下周 二 天气 还 好 吧	t m n d a y	天气 查询	n v
未来 几 天 天气	t m q n	天气 查询	n v
今天 下午 下 不 下雨 呀	t t f d v y	天气 查询	n v
今天 晚上 下雨 吗	t t v y	天气 查询	n v
今天 下 不 下雨 啊	t f d v y	天气 查询	n v
惠州 四月 十日 下雨 吗	ns t t v y	天气 查询	n v
告诉 我 杭州 这 周末 天气	v r ns r t n	天气 查询	n v
深圳 这 周末 天气	ns r t n	天气 查询	n v
南阳 天气预报	ns n	天气 查询	n v
宁波 这个 月 天气	ns r n n	天气 查询	n v
成都 下周 四 天气预报	ns t m n	天气 查询	n v
菏泽 后面 3 天 天气	ns f m q n	天气 查询	n v
杭州 14 号 的 天气 情况	ns m q u n n	天气 查询	n v
沈阳 周五 天气预报	ns t n	天气 查询	n v
春节 天气预报	t n	天气 查询	n v
今天 天气 情况	t n n	天气 查询	n v
一月 一 号 天气预报	t m q n	天气 查询	n v
三天 天气预报	nz n	天气 查询	n v
下 个 礼拜 的 天气预报	f q n u n	天气 查询	n v
昌邑 国庆节 天气	ns t n	天气 查询	n v
鞍山 周五 天气	ns t n	天气 查询	n v
深圳 后面 3 天 天气预报	ns f m q n	天气 查询	n v
2月10 号 左右 襄阳 天气	m q m ns n	天气 查询	n v
杭州 下周 六 天气 怎么样	ns t m n r	天气 查询	n v
漳州 今天 天气 情况	ns t n n	天气 查询	n v
常德 天气预报	ns n	天气 查询	n v
14 号 天气 怎么样	m q n r	天气 查询	n v
这个 礼拜 无锡 天气 怎样	r n ns n r	天气 查询	n v
今天 晚上 东营 天气 好 不 好	t t ns n a d a	天气 查询	n v
中秋 长沙 天气 情况	t ns n n	天气 查询	n v
告诉 我 保定 昨天 天气 情况	v r ns t n n	天气 查询	n v
周四 天气 咋样	t n r	天气 查询	n v
一月 一 号 天气 好 吗	t m q n a y	天气 查询	n v
沧州 今天 的 天气	ns t u n	天气 查询	n v
郑州 周末 天气 情况	ns t n n	天气 查询	n v
扬州 未来 七 天 的 天气	ns t m q u n	天气 查询	n v
6月1日 天气预报	t n	天气 查询	n v
八月 八号 的 天气 情况	t nz u n n	天气 查询	n v
未来 七 天 青岛 天气	t m q ns n	天气 查询	n v
未来 七 天 天津 天气	t m q ns n	天气 查询	n v
告诉 我 周末 哈尔滨 的 天气	v r t ns u n	天气 查询	n v
请问 这 周末 惠州 的 天气 情况	v r t ns u n n	天气 查询	n v
请问 三 天 期间 厦门 天气	v m q f ns n	天气 查询	n v
周五 东营 天气	t ns n	天气 查询	n v
周日 许昌 天气预报	t nr n	天气 查询	n v
周日 淮安 的 天气	t ns u n	天气 查询	n v
未来 五 天 株洲 天气	t m q ns n	天气 查询	n v
周四 泰安 天气	t ns n	天气 查询	n v
14 号 期间 烟台 天气	m q f ns n	天气 查询	n v
期间 周口 天气	f ns n	天气 查询	n v
下周 五 天气 情况	t m n n	天气 查询	n v
现在 盐城 天气	t ns n	天气 查询	n v
国庆节 徐州 天气 好 吗	t ns n a y	天气 查询	n v
周末 那天 鞍山 天气 好 吗	t r ns n a y	天气 查询	n v
未来 七 天 东营 天气	t m q ns n	天气 查询	n v
下周 襄阳 天气 好 么	t ns n a y	天气 查询	n v
八月 八号 菏泽 天气	t nz ns n	天气 查询	n v
一月 一 号 天气	t m q n	天气 查询	n v
下周 四 淮安 天气 好 么	t m ns n a y	天气 查询	n v
昨天 的 天气 情况	t u n n	天气 查询	n v
四月 十 号 菏泽 天气	t m q ns n	天气 查询	n v
吉林 10月24日 天气	ns t n	天气 查询	n v
徐州 十二月 二十 号 天气预报	ns t m q n	天气 查询	n v
漳州 四月 十 号 天气 情况	ns t m q n n	天气 查询	n v
东营   天气	ns w n	天气 查询	n v
郴州 下周 六 天气	ns t m n	天气 查询	n v
烟台   天气预报	ns w n	天气 查询	n v
大盘 指数	n n	股票 查询	n v
丰田 汽车 股价	nz n n	股票 查询	n v
英国 石油 明天 早上 成交量	ns n t t n	股票 查询	n v
雀巢 下周 四 股票 行情	nz t m n n	股票 查询	n v
anthem 股票 行情	nx n n	股票 查询	n v
anthem 今天 行情	nx t n	股票 查询	n v
伯克希尔 － 哈撒韦 今天 走势	nr w nr t n	股票 查询	n v
八月 八号 中国 平安 保险 股价	t nz ns n n n	股票 查询	n v
2月10 号 左右 州立 农业 保险 成交量	m q m b n n n	股票 查询	n v
今天 晚上 上海 汽车 行情	t t ns n n	股票 查询	n v
周末 塔吉特 股票 走势	t n n n	股票 查询	n v
沃尔玛 股价	nr n	股票 查询	n v
意大利 国家 电力 周末 股价	ns n n t n	股票 查询	n v
雀巢 下周 末 成交量	nz t f n	股票 查询	n v
克罗格 十二月 二十 号 股票 行情	nr t m q n n	股票 查询	n v
太平洋 建设 今天 行情	ns vn t n	股票 查询	n v
西门子 走势	nz n	股票 查询	n v
西门子 股价	nz n	股票 查询	n v
太平洋 建设 三 天 股价	ns vn m q n	股票 查询	n v
安盛 劳动节 成交量	ns nz n	股票 查询	n v
嘉 能 可 6月1日 股票 行情	tg v v t n n	股票 查询	n v
意大利 忠利 保险 行情	ns n n n	股票 查询	n v
中国 华润 总 走势	ns n b n	股票 查询	n v
托克 股价	nr n	股票 查询	n v
荷兰 皇家 壳牌 石油 下周 四 股价	ns n n n t m n	股票 查询	n v
微软 今天 成交量	nt t n	股票 查询	n v
埃尼 石油 下周 股票 行情	nr n t n n	股票 查询	n v
美国 电话 电报 股价	ns n n n	股票 查询	n v
德国 电信 今天 股价	ns n t n	股票 查询	n v
宝洁 下周 五 成交量	nz t m n	股票 查询	n v
瓦莱罗 能源 明天 早上 股票 行情	nr n t t n n	股票 查询	n v
日本 邮政 控股 行情	ns n vn n	股票 查询	n v
国家 电网 今天 晚上 走势	n n t t n	股票 查询	n v
现代 汽车 股价	t n n	股票 查询	n v
博世 9月10 号 股价	nz m q n	股票 查询	n v
美国 康卡斯特 电信 周五 成交量	ns nz n t n	股票 查询	n v
意大利 忠利 保险 10月24日 股票 行情	ns n n t n n	股票 查询	n v
家得宝 市值	n n	股票 查询	n v
州立 农业 保险 股票 走势	b n n n n	股票 查询	n v
中国 人寿保险 股价	ns n n	股票 查询	n v
空中客车 下 个 礼拜 股价	n f q n n	股票 查询	n v
中国 南方 工业 9月10 号 成交量	ns f n m q n	股票 查询	n v
国际 商业 机器 今天 晚上 股票 行情	n n n t t n n	股票 查询	n v
沃博 联 市值	nr vg n	股票 查询	n v
墨西哥 石油 股票 行情	ns n n n	股票 查询	n v
空中客车 股价	nz n	股票 查询	n v
微软 未来 几 天 股价	nt t m q n	股票 查询	n v
嘉 能 可 14 号 成交量	tg v v m q n	股票 查询	n v
福特 汽车 这个 礼拜 股票 行情	nz n r n n n	股票 查询	n v
cvs   health 市值	nx w nx n	股票 查询	n v
墨西哥 石油 股价	ns n n	股票 查询	n v
alphabet 今天 晚上 股价	nx t t n	股票 查询	n v
摩根大通 未来 七 天 成交量	i t m q n	股票 查询	n v
上海 汽车 春节 股票 行情	ns n t n n	股票 查询	n v
上海 汽车 市值	ns n n	股票 查询	n v
中国 平安 保险 股价	ns n n n	股票 查询	n v
安盛 后天 股价	ns n n	股票 查询	n v
中国 农业 银行 下 个 礼拜 成交量	ns n n f q n n	股票 查询	n v
中国工商银行 今天 股票 行情	nz t n n	股票 查询	n v
宝洁 市值	nz n	股票 查询	n v
德国 电信 周四 走势	ns n t n	股票 查询	n v
西门子 周末 行情	nz t n	股票 查询	n v
意大利 忠利 保险 周四 成交量	ns n n t n	股票 查询	n v
波音 股票 行情	b n n	股票 查询	n v
中国 平安 保险 股票 行情	ns n n n n	股票 查询	n v
法国 农业 信贷 银行 股票 走势	ns n n n n n	股票 查询	n v
上证 指数	j n	股票 查询	n v
深证 成指 指数	j j n	股票 查询	n v
港股 指数	n n	股票 查询	n v
美股 指数	n n	股票 查询	n v
创业板 指数	n n	股票 查询	n v
新三板 指数	n n	股票 查询	n v
中国 人寿保险 股价	ns n n	股票 查询	n v
中国 华润 总 股份 有限公司 股价	ns nz b n n n	股票 查询	n v
俄罗斯 天然气 工业 股份 有限公司 股价	ns n n n n n	股票 查询	n v
潍坊 安盛 股份 有限公司 股价	ns ns n n n	股票 查询	n v
日产 汽车 股份 有限公司 股价	nz n n n n	股票 查询	n v
中国 铁道 建筑 总 股份 有限公司 股价	ns n n b n n n	股票 查询	n v
好 市 多 股份 有限公司 股价	a n a n n n	股票 查询	n v
日立 股份 有限公司 股价	nz n n n	股票 查询	n v
鸿海 精密 工业 股份 股价	n a n n n	股票 查询	n v
保定 雀巢 股份 股价	ns nz n n	股票 查询	n v
吉林 意大利 国家 电力 股份 有限公司 股价	ns ns n n n n n	股票 查询	n v
长沙 中国 铁道 建筑 总 股份 有限公司 股价	ns ns n n b n n n	股票 查询	n v
哈尔滨 中国 铁路 工程 总 股份 有限公司 股价	ns ns n n b n n n	股票 查询	n v
沈阳 巴斯夫 股份 有限公司 股价	ns nz n n n	股票 查询	n v
中国 石油 天然气 股份 有限公司 股价	ns n n n n n	股票 查询	n v
中国 华润 总 股份 有限公司 股价	ns nz b n n n	股票 查询	n v
中国 平安 保险 股份 股价	ns n n n n	股票 查询	n v
家得宝 股份 有限公司 股价	n n n n	股票 查询	n v
好 市 多 股份 股价	a n a n n	股票 查询	n v
徐州 意 昂 集团 股份 有限公司 股价	ns ng ag n n n n	股票 查询	n v
连云港 大众 股份 有限公司 股价	ns nz n n n	股票 查询	n v
绍兴 墨西哥 石油 乳业 股价	ns ns n n n	股票 查询	n v
通用 电气 股份 有限公司 股价	nz n n n n	股票 查询	n v
常州 日立 股份 有限公司 股价	ns nz n n n	股票 查询	n v
东莞 exor 股份 有限公司 股价	ns nx n n n	股票 查询	n v
限行	v	限行 查询	v v
限行 情况	v n	限行 查询	v v
限行 信息	v n	限行 查询	v v
告诉 我 限行 的 情况	v r v u n	限行 查询	v v
长沙 下周 末 限行	ns t f v	限行 查询	v v
淮安 这 周末 限行	ns r t v	限行 查询	v v
无锡 下周 六 限行	ns t m v	限行 查询	v v
连云港 下周 末 限行	ns t f v	限行 查询	v v
太原 下周 二 也 限行	ns t m d v	限行 查询	v v
四月 十 号 限 号 是 尾 号 为 2	t m q ng n v ng n v m	限行 查询	v v
未来 七 天 限 号 尾 号	t m q ng q ng q	限行 查询	v v
下 个 礼拜 限 号 尾 号	f q n ng q ng q	限行 查询	v v
威海 这个 礼拜 限行	ns r n v	限行 查询	v v
中山 限行 信息	ns v n	限行 查询	v v
成都 限行 信息	ns v n	限行 查询	v v
深圳 明天 限行 吗	ns t v y	限行 查询	v v
这 周末 连云港 限行 吗	r t ns v y	限行 查询	v v
八月 八号 临沂 限行 吗	t nz ns v y	限行 查询	v v
下周 五 青岛 限行 吗	t m ns v y	限行 查询	v v
周口 春节 限行 吗	ns t v y	限行 查询	v v
9月10 号 衡阳 限行 吗	m q ns v y	限行 查询	v v
泉州 后天 限行 吗	ns n v y	限行 查询	v v
春节 漳州 限行 的 尾 号 是 1 吗	t ns v u ng n v m y	限行 查询	v v
明天 早上 温州 限 不 限行	t t ns ng d v	限行 查询	v v
下周 末 廊坊 限 不 限行	t f ns ng d v	限行 查询	v v
清明 茂名 限 不 限行	t ns ng d v	限行 查询	v v
周日 漳州 限 不 限行	t ns ng d v	限行 查询	v v
盐城 下周 全天 限行	ns t t v	限行 查询	v v
淄博 周四 全天 限行	ns t t v	限行 查询	v v
杭州 外地车 限行 吗	ns n v y	限行 查询	v v
外地车 邯郸 限行 吗	n ns v y	限行 查询	v v
德州 外地车 限行 吗	ns n v y	限行 查询	v v
外地车 苏州 限行 吗	n ns v y	限行 查询	v v
廊坊 外地 车牌 限行 时间	ns s n v n	限行 查询	v v
国庆节 保定 限行 新 规定 及 限行 时间	t ns v a n c v n	限行 查询	v v
苏州 国庆节 不 限行 吗	ns t d v y	限行 查询	v v
衡阳 限行 最 新 通知	ns v d a n	限行 查询	v v
长春 限行 最 新 通知	ns v d a n	限行 查询	v v
常德 限行	ns v	限行 查询	v v
宁波 限行	ns v	限行 查询	v v
成都 今天 限行 吗	ns t v y	限行 查询	v v
成都 限行 吗	ns v y	限行 查询	v v
成都 限行 么	ns v y	限行 查询	v v
许昌 外地 牌照 限行	nr s n v	限行 查询	v v
江门 沪 c 限行	ns j nx v	限行 查询	v v
潍坊 高架 限行	ns n v	限行 查询	v v
惠州 外地 牌照 限行	ns s n v	限行 查询	v v
佛山 下周 不 限行	ns t d v	限行 查询	v v
襄阳 限行 区域	ns v n	限行 查询	v v
扬州 限行 区域	ns v n	限行 查询	v v
漳州 限行 规定	ns v n	限行 查询	v v
南宁 限行 规定	ns v n	限行 查询	v v
许昌 限行 政策	nr v n	限行 查询	v v
东莞 限行 政策	ns v n	限行 查询	v v
劳动节 株洲 限行 么	t ns v y	限行 查询	v v
明天 石家庄 单 号 限行 么	t ns m q v y	限行 查询	v v
泉州 有 限行 么	ns v v y	限行 查询	v v
后天 金华 限行 吗	n ns v y	限行 查询	v v
常德 春节 限行 规定 是 怎样 的	ns t v n v r u	限行 查询	v v
告诉 我   新乡 限行 么	v r w ns v y	限行 查询	v v
今天 新乡 限行 吗	t ns v y	限行 查询	v v
滨州 昨天 限行 不 限行	ns t v d v	限行 查询	v v
明天 早上 常德 限行 不	t t ns v d	限行 查询	v v
十二月 二十 号 济南 限行 么	t m q ns v y	限行 查询	v v
请问 下周 四 金华 限 不 限行	v t m ns ng d v	限行 查询	v v
我 想 知道 2月10 号 左右 佛山 限行 情况	r v v m q m ns v n	限行 查询	v v
十二月 二十 号 的 时候 咸阳 限行 吗	t m q u n ns v y	限行 查询	v v
四月 十日 限行 么	t t v y	限行 查询	v v
5 号 成都 限行 吗	m q ns v y	限行 查询	v v
国庆节 威海 不 限行 呢	t ns d v y	限行 查询	v v
惠州 限行 吗	ns v y	限行 查询	v v
告诉 我 湛江 下周 六 限行 规定	v r ns t m v n	限行 查询	v v
后面 3 天 限行 吗	f m q v y	限行 查询	v v
郴州 今天 限行 么	ns t v y	限行 查询	v v
鄂尔多斯 九月 十一二 限行 吗	ns t m v y	限行 查询	v v
中秋 株洲 限行 吗	t ns v y	限行 查询	v v
明天 洛阳 限行 么	t ns v y	限行 查询	v v
今天 晚上 温州 限行 么	t t ns v y	限行 查询	v v
9月10 号 乌鲁木齐 限 不 限行	m q ns ng d v	限行 查询	v v
期间 淮安 限行 吗	f ns v y	限行 查询	v v
今天 晚上 期间 限行 吗	t t f v y	限行 查询	v v
明天 那天 乌鲁木齐 限行 吗	t r ns v y	限行 查询	v v
十二月 二十 号 限行 么	t m q v y	限行 查询	v v
周四 那天 限行 吗	t r v y	限行 查询	v v
未来 五 天 漳州 限行 吗	t m q ns v y	限行 查询	v v
清明 杭州 限 不 限行 呢	t ns ng d v y	限行 查询	v v
春节 昆明 限行 吗	t ns v y	限行 查询	v v
昆明 14 号 限 不 限行	ns m q ng d v	限行 查询	v v
清明 包头 限行 情况	t ns v n	限行 查询	v v
今天 无锡 限行 吗	t ns v y	限行 查询	v v
现在 泰安 限行 吗	t ns v y	限行 查询	v v
下 个 礼拜 岳阳 限行 么	f q n ns v y	限行 查询	v v
昆明 限行 吗	ns v y	限行 查询	v v
下周 二 限行 吗	t m v y	限行 查询	v v
珠海   限行 政策	ns w v n	限行 查询	v v
周末 限 不 限行	t v d v	限行 查询	v v
周四 那天 郴州 限行 吗	t r ns v y	限行 查询	v v
下周 末 期间 柳州 限行 吗	t f f ns v y	限行 查询	v v
下周 五 株洲 限行 么	t m ns v y	限行 查询	v v
广州 限行 政策	ns v n	限行 查询	v v
跳转 到 画 骨 夫妇 相遇 的 片段	v p n ng n v u n	内容 跳转	n v
跳转 到 李晨 出现 的 片段	v p nr v u n	内容 跳转	n v
我 要 看 周笔畅 出场 的 那 段	r v v nr v u r q	内容 跳转	n v
我 要 看 王丽坤 哭 的 那 段	r v v nr v u r q	内容 跳转	n v
我 要 看 王源 和 吴彦祖 拥抱 的 那段	r v v nr c nr v u r	内容 跳转	n v
我 要 看 臣妾做不到啊 的 那段	r v v nz u r	内容 跳转	n v
我 要 看 真相大白 的 那段	r v v i u r	内容 跳转	n v
跳转 到 一生所爱 响起 的 片段	v p nz v u n	内容 跳转	n v
我 要 看 佟丽娅 被 一 枪 打中 头部 的 那段	r v v nr p m q v n u r	内容 跳转	n v
直接 放 吴秀波 从 楼顶 被 扔 下来 那 段 眼 神戏	ad v nr p n p v v r q n n	内容 跳转	n v
直接 跳 到 学生 一起 站 在 桌上 那里	ad v p n d v p s r	内容 跳转	n v
跳转 到 向华强 被 围攻 那里	v p nr p v r	内容 跳转	n v
跳转 到 下雪 那里	v p n r	内容 跳转	n v
我 要 看 开头 那 一 段	r v v n r m q	内容 跳转	n v
直接 放 结尾 片段	ad v n n	内容 跳转	n v
给 我 放 成龙 被 导演 耍大牌 那段	p r v nr p n n r	内容 跳转	n v
给 我 看 angelababy 心里 独白 那段	p r v nr s n r	内容 跳转	n v
我 要 看 华晨宇 和 李晨 在 树 下 那段	r v v nr c nr p n f r	内容 跳转	n v
我 要 看 吴亦凡 被 一 家 灭门 那段	r v v nr p m q n r	内容 跳转	n v
放 向佐 烧 戏 服 的 那 一 段	v nr v n v u r m q	内容 跳转	n v
放 我 养 你 啊 的 那段	v r v r y u r	内容 跳转	n v
我 要 看 杨紫 和 戚薇 在 城墙 上 的 那 段	r v v nr c nr p n f u r q	内容 跳转	n v
跳转 到 张柏芝 踩 七彩 祥云 的 那段	v p nr v n nr u r	内容 跳转	n v
直接 放 斯嘉丽约翰逊 刚 出场 的 收 刀 式	ad v nr d v u v n k	内容 跳转	n v
我 想 看 林允儿 的 动作 戏	r v v nr u n n	内容 跳转	n v
我 想 看 胡歌 的 搞笑 片段	r v v nr u vn n	内容 跳转	n v
我 要 看 李易峰 的 亲热戏	r v v nr u n	内容 跳转	n v
我 要 从 情节 翻转 的 部分 开始 看	r v p n v u n v v	内容 跳转	n v
我 要 从 张柏芝 开始 推理 的 地方 开始 看	r v p nr v v u n v v	内容 跳转	n v
我 要 看 结尾 的 彩蛋	r v v n u n	内容 跳转	n v
我 想 看 结尾 的 彩蛋	r v v n u n	内容 跳转	n v
跳转 到 真相大白 的 片段	v p i u n	内容 跳转	n v
我 要 从 王彦霖 被 怀疑 开始 看	r v p nr p v v v	内容 跳转	n v
我 要 看 三 人 一起 走 出来 那段	r v v m n s v v r	内容 跳转	n v
直接 放 王彦霖 的 动作 戏	ad v nr u n n	内容 跳转	n v
从 易烊千玺 被害 开始 放	p nr vn v v	内容 跳转	n v
放 向佐 跑酷 那段	v nr v r	内容 跳转	n v
放 周星驰 在 桥 上 抽烟 那 段	v nr p n f v r q	内容 跳转	n v
我 要 看 靳东 骑 摩托车	r v v nr v n	内容 跳转	n v
我 要 看 任家萱 一个 打 十 个 的 那 段 打戏	r v v nr m v m q u r q n	内容 跳转	n v
我 要 看 穿帮 的 镜头	r v v v u n	内容 跳转	n v
直接 放 穿帮 的 那里	ad v v u r	内容 跳转	n v
从 下雪 那里 开始 放	p n r v v	内容 跳转	n v
我 想 直接 看 结尾	r v ad v n	内容 跳转	n v
跳转 到 大家 送别 张紫妍 的 片段	v p r v nr u n	内容 跳转	n v
我 要 看 林允儿 出场 的 那 段	r v v nr v u r q	内容 跳转	n v
我 要 看 迪丽热巴 哭 的 那 段	r v v nr v u r q	内容 跳转	n v
我 要 看 向华强 和 景甜 拥抱 的 那段	r v v nr c nr v u r	内容 跳转	n v
我 要 看 念 诗 的 那 段	r v v v n u r q	内容 跳转	n v
我 要 看 故事 的 高潮 部分	r v v n u n n	内容 跳转	n v
跳转 到 周笔畅 跳 车 的 片段	v v nr v n u n	内容 跳转	n v
我 要 看 田馥甄 和 薛之谦 在 楼顶 的 那段	r v v nr c nr p n u r	内容 跳转	n v
直接 放 吴京 的 眼神 戏	ad v nr u n n	内容 跳转	n v
直接 放 古力娜扎 出场 那里	ad v nr v r	内容 跳转	n v
直接 跳 到 林允儿 和 邓紫棋 的 对手戏	ad v v nr c nr u n	内容 跳转	n v
跳转 到 戚薇 被 关 到 小黑屋 那里	v p nr p v v n r	内容 跳转	n v
跳 到 挑战不可能 响起 的 地方	v p nz v u n	内容 跳转	n v
我 要 看 吴亦凡 被 戳穿 那 一 段	r v v nr p v r m q	内容 跳转	n v
直接 放 火场 救人 那段	ad v n v r	内容 跳转	n v
给 我 放 李小冉 换装 那段	p r v nr v r	内容 跳转	n v
给 我 看 鹿晗 心里 独白 那段	p r v nr s n r	内容 跳转	n v
我 要 看 田馥甄 出场 那段	r v v nr v r	内容 跳转	n v
我 要 看 少林寺 被 灭门 那段	r v v nz p n r	内容 跳转	n v
放 邓紫棋 和 黑帮 打 的 那 一 段	v nr c n v u r m q	内容 跳转	n v
放 张嘉倪 醒悟 的 那段	v nr v u r	内容 跳转	n v
我 要 看 薛之谦 和 张子枫 在一起 的 那 段	r v v nr c nr nz u r q	内容 跳转	n v
跳转 到 求婚 的 那 段	v p v u r q	内容 跳转	n v
直接 放 到 南极 那里	ad v v ns r	内容 跳转	n v
我 想 看 林俊杰 的 动作 戏	r v v nr u n n	内容 跳转	n v
我 想 看 林允儿 的 搞笑 片段	r v v nr u vn n	内容 跳转	n v
我 要 看成 龙 的 出场 部分	r v v n u vn n	内容 跳转	n v
我 要 从 任家萱 被 枪击 开始 看	r v p nr p v v v	内容 跳转	n v
我 要 从 江疏影 披 上 画皮 的 地方 开始 看	r v p nr v f n u n v v	内容 跳转	n v
直接 放 结尾 的 彩蛋	ad v n u n	内容 跳转	n v
我 想 看 真相大白 的 部分	r v v i u n	内容 跳转	n v
跳转 到 景甜 快 饿 死 那里	v p nr d v v r	内容 跳转	n v
我 要 从 郑秀文 开始 养 牛 开始 看	r v p nr v v n v v	内容 跳转	n v
我 要 看 斯嘉丽约翰逊 逼死 关晓彤 那段	r v v nr v nr r	内容 跳转	n v
直接 放 薛之谦 的 动作 戏	ad v nr u n n	内容 跳转	n v
从 王鸥 被害 开始 放	p nr vn v v	内容 跳转	n v
放 章子怡 唱 京剧 那段	v nr v n r	内容 跳转	n v
放 向华强 和 欧阳娜娜 互怼 的 部分	v nr c nr vn u n	内容 跳转	n v
我 要 看 黄子韬 告白	r v v nr v	内容 跳转	n v
我 要 看 木村拓哉 欺负 金晨 的 那 段 戏	r v v nr v nr u r q n	内容 跳转	n v
从 任家萱 和 木村拓哉 闹 分手 开始 播	p nr c nr v v v v	内容 跳转	n v
直接 放 古力娜扎 假扮 吴秀波 的 那里	ad v nr v nr u r	内容 跳转	n v
从 李晨 以 死相 逼 那里 开始 放	p nr p n v r v v	内容 跳转	n v
我 想 直接 看 骗子 被 识破	r v ad v n p v	内容 跳转	n v
只 看 黄渤 的 镜头	d v nr u n	演员 限定	n v
只 看 海陆	d v n	演员 限定	n v
只 看 李钟硕	d v nr	演员 限定	n v
只 看 郑爽 的 部分	d v nr u n	演员 限定	n v
只 看 刘亦菲 的 片段	d v nr u n	演员 限定	n v
我 只 想 看 戚薇	r d v v nr	演员 限定	n v
我 只 想 看 有 洪欣 的 地方	r d v v v nr u n	演员 限定	n v
我 只 想 看 有 许志安 的 部分	r d v v v nr u n	演员 限定	n v
我 只 想 看 章子怡 演 的 片段	r d v v nr v u n	演员 限定	n v
我 只 想 看 刘亦菲 的 镜头	r d v v nr u n	演员 限定	n v
只 看 王俊凯 出演 的 镜头	d v nr v u n	演员 限定	n v
只 看 有 金晨 出现 的 地方	d v v nr v u n	演员 限定	n v
只 看 佟丽娅 演 的 片段	d v nr v u n	演员 限定	n v
就 看 李晨	p v nr	演员 限定	n v
就 看 朱一龙 的 镜头	p v nr u n	演员 限定	n v
就 看 王源 的 片段	p v nr u n	演员 限定	n v
就 看 章子怡 的 部分	p v nr u n	演员 限定	n v
就 看 有 王彦霖 的 镜头	p v v nr u n	演员 限定	n v
就 看 有 戚薇 的 片段	p v v nr u n	演员 限定	n v
就 看 有 靳东 的 部分	p v v nr u n	演员 限定	n v
只 看 有 汪峰 的 地方	d v v nr u n	演员 限定	n v
只 看 有 陈伟霆 的 片段	d v v nr u n	演员 限定	n v
只 看 有 刘亦菲 的 镜头	d v v nr u n	演员 限定	n v
只 看 有 汪峰 的 部分	d v v nr u n	演员 限定	n v
我 只 看 张柏芝 的 戏	r d v nr u n	演员 限定	n v
我 只 看 柳岩 出演 的 镜头	r d v nr v u n	演员 限定	n v
我 就 想 看 有 陈楚生 的 地方	r d v v v nr u n	演员 限定	n v
我 就 想 看 刘亦菲 演 的 片段	r d v v nr v u n	演员 限定	n v
只 放 汪峰	d v nr	演员 限定	n v
只 放 有 张馨予 的 部分	d v v nr u n	演员 限定	n v
只 放 胡歌 出现 的 片段	d v nr v u n	演员 限定	n v
只 放 汪峰 的 镜头	d v nr u n	演员 限定	n v
只 放 杨紫 出演 的 镜头	d v nr v u n	演员 限定	n v
只 放 华晨宇 出演 的 部分	d v nr v u n	演员 限定	n v
只 放 佟丽娅 的 戏	d v nr u n	演员 限定	n v
我 只要 看 胡歌 的 戏	r c v nr u n	演员 限定	n v
我 只要 看 柳岩 的 镜头	r c v nr u n	演员 限定	n v
我 只要 看 有 刘诗诗 出现 的 地方	r c v v nr v u n	演员 限定	n v
我 只要 看 刘亦菲 出现 的 部分	r c v nr v u n	演员 限定	n v
我 只要 看 有 郑爽 的 片段	r c v v nr u n	演员 限定	n v
我 要 看 对不起我是警察 的 那段	r v v nz u r	内容 跳转	n v
我 要 看 出来混迟早是要还的 那 段	r v v nz r q	内容 跳转	n v
我 要 看 我 是 假 霸王 你 是 真 虞姬 的 片段	r v v r v a n r v a nr u n	内容 跳转	n v
我 要 看 最 好 的 威胁 是 不 采取 行动 那段	r v v d a u vn v d v vn r	内容 跳转	n v
我 要 看 我 不 想 死 我 要 活 着 的 那 段	r v v r d v v r v v u u r q	内容 跳转	n v
我 要 看 但 你 不 可以 说 我 是 臭 跑龙套 的 那段	r v v c r d v v r v a n u r	内容 跳转	n v
我 要 看 曾经 有 份 真挚 的 爱情 放 在 我 面前 那段	r v v d v q a u n v p r f r	内容 跳转	n v
我 要 看 我 的 意中人 是 个 盖世英雄 的 那段	r v v r u n v q i u r	内容 跳转	n v
我 要 看 那个人 好像 一 条 狗 诶 的 那 段	r v v nr d m q n e u r q	内容 跳转	n v
我 要 看 人 是 人 他 妈 生 的 那 段	r v v n v n r n v u r q	内容 跳转	n v
我 要 看 我 猜 到 了 开头 却 猜 不 中 结局 的 那 段	r v v r v v u n d v d f n u r q	内容 跳转	n v
我 要 看 这个 鱼塘 被 你 承包 了 的 那 段	r v v r n p r v u u r q	内容 跳转	n v
我 要 看 让 我 去 睡服 他 的 那段	r v v v r v v r u r	内容 跳转	n v
我 要 看 我 恨 你 但 我 也 只有你 的 那 段	r v v r v r c r d nz u r q	内容 跳转	n v
我 要 看 下辈子 我 一定 会 找到你 的 那 段	r v v t r d v nz u r q	内容 跳转	n v
我 要 看 我 失去 的 东西 一定 要 亲手 拿 回来 的 那 段	r v v r v u n d v d v v u r q	内容 跳转	n v
我 要 看 还有 谁 的 那 段	r v v v r u r q	内容 跳转	n v
只 看 斯嘉丽约翰逊 和 江疏影	d v nr c nr	演员 限定	n v
只 看 任家萱 和 邓紫棋	d v nr c nr	演员 限定	n v
我 只 看 陈慧琳 和 张艺兴	r d v nr c nr	演员 限定	n v
我 只 看 斯嘉丽约翰逊 和 木村拓哉	r d v nr c nr	演员 限定	n v
我 只 想 看 田馥甄 和 刘亦菲	r d v v nr c nr	演员 限定	n v
就 看 周笔畅 和 易烊千玺	p v nr c nr	演员 限定	n v
我 只要 看 田馥甄 和 海陆	r c v nr c nr	演员 限定	n v
只 看 有 刘诗诗 和 黄子韬 的 部分	d v v nr c nr u n	演员 限定	n v
只 看 李易峰 和 海陆	d v nr c nr	演员 限定	n v
我 只 想 看 迪丽热巴 和 戚薇	r d v v nr c nr	演员 限定	n v
只 看 王源 和 田馥甄 的 镜头	d v nr c nr u n	演员 限定	n v
只 看 张紫妍 和 黄明昊 的 部分	d v nr c nr u n	演员 限定	n v
只 看 有 王彦霖 和 黄明昊 的 地方	d v v nr c nr u n	演员 限定	n v
我 只要 看 薛之谦 和 郭德纲	r c v nr c nr	演员 限定	n v
只 放 章子怡 和 靳东 的 镜头	d v nr c nr u n	演员 限定	n v
我 只 看 范冰冰 和 张国荣	r d v nr c nr	演员 限定	n v
我 只 看 汪峰 和 王俊凯	r d v nr c nr	演员 限定	n v
温州 今天 有 雨 吗	ns t v n y	天气 查询	n v
呼和浩特 昨天 是不是 雨天	ns t nz n	天气 查询	n v
湛江 八月 八号 雨停 吗	ns t nz v y	天气 查询	n v
台州 有没有 雨	ns n n	天气 查询	n v
镇江 雨停 吗	ns v y	天气 查询	n v
未来 七 天 是 晴天 吗	t m q v n y	天气 查询	n v
扬州 是 晴天 还是 雨天	ns v n c n	天气 查询	n v
株洲 一月 一 号 是不是 会 下雨	ns t m q nz v v	天气 查询	n v
深圳 清明 是 晴天 吗	ns t v n y	天气 查询	n v
南阳 下周 五 是不是 雨天	ns t m nz n	天气 查询	n v
绍兴 是不是 会 下雨	ns nz v v	天气 查询	n v
长沙 后面 3 天 是 晴天 还是 雨天	ns f m q v n c n	天气 查询	n v
滨州 后面 3 天 是不是 晴天	ns f m q nz n	天气 查询	n v
广州 有没有 雨	ns n n	天气 查询	n v
厦门 9月10 号 是 雨天 吗	ns m q v n y	天气 查询	n v
廊坊 今天 是不是 雨天	ns t nz n	天气 查询	n v
宁波 5 号 是不是 会 下雨	ns m q nz v v	天气 查询	n v
咸阳 未来 3 天 有 雨 吗	ns t m q v n y	天气 查询	n v
新乡 今天 雨 会 不 会 停	ns t n v d v v	天气 查询	n v
周五 是不是 晴天	t nz n	天气 查询	n v
兰州 5 号 有没有 雨	ns m q n n	天气 查询	n v
保定 今天 雨 会 不 会 停	ns t n v d v v	天气 查询	n v
榆林 这个 礼拜 是不是 雨天	ns r n nz n	天气 查询	n v
连云港 有没有 雨	ns n n	天气 查询	n v
沧州 是不是 晴天	ns nz n	天气 查询	n v
这个 月 镇江 雨停 吗	r n ns v y	天气 查询	n v
今天 鞍山 有 雨 吗	t ns v n y	天气 查询	n v
周四 南宁 是 雨天 吗	t ns v n y	天气 查询	n v
今天 株洲 是不是 会 下雨	t ns nz v v	天气 查询	n v
四月 十 号 德州 是不是 晴天	t m q ns nz n	天气 查询	n v
后面 3 天 乌鲁木齐 雨 会 不 会 停	f m q ns n v d v v	天气 查询	n v
14 号 珠海 是 晴天 吗	m q ns v n y	天气 查询	n v
周五 有没有 雨	t n n	天气 查询	n v
这个 月 宜昌 是 雨天 吗	r n ns v n y	天气 查询	n v
14 号 株洲 有没有 雨	m q ns n n	天气 查询	n v
6月1日 惠州 有 雨 吗	t ns v n y	天气 查询	n v
下周 是不是 晴天	t nz n	天气 查询	n v
国庆节 盐城 是 雨天 吗	t ns v n y	天气 查询	n v
一月 一 号 是不是 晴天	t m q nz n	天气 查询	n v
今天 下午 咸阳 是不是 晴天	t t ns nz n	天气 查询	n v
四月 十 号 福州 有 雨 吗	t m q ns v n y	天气 查询	n v
春节 长 春雨 会 不 会 停	t a n v d v v	天气 查询	n v
下周 四有 雨 吗	t j n y	天气 查询	n v
广州 雨 会 不 会 停	ns n v d v v	天气 查询	n v
后面 3 天 南通 是 晴天 吗	f m q ns v n y	天气 查询	n v
14 号 廊坊 是不是 晴天	m q ns nz n	天气 查询	n v
下周 末 徐州 是 雨天 吗	t f ns v n y	天气 查询	n v
是 晴天 吗	v n y	天气 查询	n v
2月10 号 左右 深圳 有没有 雨	m q m ns n n	天气 查询	n v
未来 3 天 洛阳 有 雨 吗	t m q ns v n y	天气 查询	n v
国庆节 广州 下雨 吗	t ns v y	天气 查询	n v
后天 聊城 是不是 晴天	n ns nz n	天气 查询	n v
是不是 雨天	nz n	天气 查询	n v
下周 青岛 有没有 雨	t ns n n	天气 查询	n v
上海 有没有 雨	ns n n	天气 查询	n v
今天 长春 是不是 晴天	t ns nz n	天气 查询	n v
下周 四 淮安 会 不 会 停	t m ns v d v v	天气 查询	n v
雨 会 不 会 停	n v d v v	天气 查询	n v
大庆 会 不 会 停	ns v d v v	天气 查询	n v
一月 一 号 台州 有 雨 吗	t m q ns v n y	天气 查询	n v
国庆节 襄阳 雨停 吗	t ns v y	天气 查询	n v
中秋 惠州 是 晴天 吗	t ns v n y	天气 查询	n v
今天 湛江 雨 会 不 会 停	t ns n v d v v	天气 查询	n v
下周 末 长春 是不是 会 下雨	t f ns nz v v	天气 查询	n v
镇江 有 雨 吗	ns v n y	天气 查询	n v
昨天 常州 雨 会 不 会 停	t ns n v d v v	天气 查询	n v
烟台 是不是 会 下雨	ns nz v v	天气 查询	n v
这个 月 洛阳 雨停 吗	r n ns v y	天气 查询	n v
有没有 雨	n n	天气 查询	n v
石家庄 雨停 吗	ns v y	天气 查询	n v
是不是 会 下雨 9月10 号 佛山	nz v v m q n	天气 查询	n v
是 晴天 吗 济宁	v n y ns	天气 查询	n v
是 晴天 还是 雨天 三 天 厦门	v n c n m q ns	天气 查询	n v
是不是 雨 天下 周四 金华	nz n n t ns	天气 查询	n v
是不是 雨天 芜湖	nz n ns	天气 查询	n v
是 晴天 还是 雨天 昨天 上海	v n c n t ns	天气 查询	n v
有没有 雨 春节 南阳	n n t ns	天气 查询	n v
是不是 晴天 下 个 礼拜 济南	nz n f q n ns	天气 查询	n v
都 挺 好 的 主演	d d a u n	演员 查询	n v
听雪楼 的 主演	n u n	演员 查询	n v
破冰行动 的 主演	nz u n	演员 查询	n v